අං	Horns
අංක	No.
අංකල්	Uncle
අංකුර	Shoots
අංග	Features
අංගචලන	Wear
අංගනය	Yard
අංගනයකට	Yard
අංගනයට	Park
අංගනයේ	Yard
අංගනයේදී	Yard
අංගනවලට	Compound
අංගය	Feature
අංගයක්ද	Even part
අංගයකි	Component
අංගයන්ගෙන්	Features
අංගවල	ACTS
අංගවිකල	Handicapped
ඔහු            he
අංගසම්පූර්ණ	Fullyequipped
අංගොඩ	angoda
අංගෝපාංග	Features
අංගෝපාංගයන්	Features
අංගෝපාංගවලින්	Features
විද්‍යාගාරයක්       laboratory
විද්‍යාගාරය           laboratory
මුදල්             money
මුදල             money
අංවලින්	Horns
අංශ	Divisions
අංශක	Degrees
අංශබාගය	Paralytic
අංශභාග	Paralyzed
අංශය	Section
අංශයකම	Sectors
අංශයක්	Section
අංශාධිපති	Head
අංශු	Particles
අංශුමාත්‍ර	Trace
අංශුව	Particle
අකටයුත්තක්	Irregularity
අකමැත්ත	Objections
අකරතැබ්බයක්	Scenario
අකර්මණ්‍ය	Passive
අකර්යක්ෂම	Ineffective
අකර්ශනීය	attractive
අකර්ෂණීය	attractive
අකලංක	Unblemished
අකල්	Untimely
අක්කා	elder sister
අක්කර	acres
අක්කරය	Acres
අක්බඹරු	Curly
අක්මාවේ	Liver
අක්මීමන	akmmemana
අක්ෂය	Axis
අක්ෂාංශය	Latitude
අක්ෂාංශවල	Latitudes
අක්ෂි	Eye
අක්‍රමවත්	Unusual
අක්‍රමිකතා	Irregularities
අක්‍රමිකතාව	Disorder
අක්‍රමිකතාවක්	Irregularity
අක්‍රිය	Inactive
අකාබනික	Inorganic
අකාරයට	Abyss
අකාරයටත්	Alphabetical
අකාර්යක්ෂම	Ineffective
අකාරුණික	Mistreatment
අකාලයේ	Untimely
අකැමැත්ත	Unwillingness
අකීකරු	Disobedience
අකුණක	Lightning
අකුර	letter
අකුරු	letters
අකුල	bill
අකුල්	Mosaic
අකුලා	Withdrawn
අකුලාගෙන	packed
අකුසල	Effaced
අකුළන	Scroll
අකුළා	rolled
අඛණ්ඩ	Continuous
අඛණ්ඩතාවය	Continuity
අඛණ්ඩව	Continue
අග	End
අගට	End
අගත්	End
අගති	Unprejudiced
අගතිගාමිවන	Unprejudiced
අගතිගාමී	Biased
අගතිය	Prejudice
අගතියක්	Prejudice
අගතියට	Prejudice
අගතියෙන්	Prejudice
අගදී	End
අගනගරය	Capital
අගන්‍යාශ	pancreas
අගන්‍යාශයේ	pancreas
අගනා	Excellent
අගනුවර	capital
අගනේ	Worth
අගපසඟ	features
අගභාගයේ	LATE
අගමැති	Prime Minister
අගමුල්	Anatomy
අගය	value
අගයනවා     Appreciating
අගයෙන්	value
අගරජ	Emperor
අගරජු	Emperor
අගරදගුරු	Archbishop
අගරු	Dishonored
අගලක	Moat
අගලකට	Moat
අගලේ	Moat
අගවන	Svalbard
අගවමින්	Heavily
අගවිනිසුරු	Justice
අගහරුවාදාය	Tuesday
අගහිගකම්වලින්	poverty
අගහිඟකම්	Needy
අග්ගලා	Sage
අග්නි	fire
අග්නිදිග	Southeast
අග්‍ර	Chief
අග්‍රගණ්‍ය	Distinguished
අග්‍රය	Terminal
අග්‍රයේ	Console
අග්‍රවිනිශ්චයකාර	Justice
අග්‍රාණ්ඩුකාරවරයා	Represented
අග්‍රාමාත්‍ය	Prime
අගාධයකට	Abyss
අගාධයට	Abyss
අගාධයෙන්	Abyss
අගැයීමකට	Appraisal
අගැයීමක්	Appraisal
අගැයීමට	Revaluation
අගැයුම්	Evaluation
අගුලට	lock
අගුල්	lock
අගුලු	lock
අගුවක	lock
අගුළු	lock
අගේ	groovy
අගේට	groovy
අගොස්තුවේදී	August
අගෝස්තු	August
අගෝස්තුවේ	August
අගෝස්තුවේදී	August
අගෞරවයක්	discourtesy
අඟ	horn
අඟක්	horn
අඟනෝ	ladies
අඟපසඟ	features
අඟලක්	inch
අඟල්	inches
අඟලෙන්	inch
අඟවති	hints
අඟහරු	mars
අඟහරුගේ	mars
අඟහරුවා	mars
අඟහරුවාදා	Tuesday
අඟහරුවාදාට	Tuesday
අඟහරුවාදාය	Tuesday
අඟහිඟ	poverty
අඟුරු	carbon
අඟුරුබවට	carbon
අඟුලට	boat
අඟුළු	bolt
අඟුළුවා	Anguluwa
අචල	constant
අචලව	constant
අච්චාරු	pickle
අච්චාරුවකට	pickle
අච්චු	dies
අච්චුද	dies
අචාර්ය	teacher
අචීචිමහ	inferno
අජීර්ණ	indigestion
අජීව	dead
අජීවි	dead
අජේ	ajey
අඥාත	anonymous
අඥාන	foolish
අට	eight
අටපට්ටම්	octagonal
අටපිරිකර	requisites
අටමස	eight months
අටමස්ථාන	Atamasthanaya
අටමස්ථානයට	Atamasthanaya
අටයි	eight
අටරියන්	eight cubits
අටලක්ෂයකට	eightlakh
අටවන	eighth
අටවැනි	eighth
අටසිය	eighthundrad
අටසියකට	eighthundrad
අටසිල්	eightprecepts
අටසීයක්	eighthundrad
අටහැවිරිදි	eight
අටළොස්	eighteen
අට්ටාල	stage
අටියෙන්	desire
අටියෙනි	desire
අටු	barn
අටුකොටු	barn
අටුකොටුව	barn
අටුකොටුවද	barn
අටුව	barn
අටුවා	commentary
අටුවාව	commentary
අටුවාවක්	commentary
අටුවේ	barn
අටෙන්	eighth
අටේ	eight
අඩ	half
අඩංගු	contained
අඩක	half
අඩන්තේට්ටම්	assault
අඩපණ	exhausted
අඩම්තේට්ටම්වලට	assault
අඩමාන	precarious
අඩවන්	half
අඩවිය	forest
අඩස්සියකට	imprisonment
අඩසිය	half century
අඩසියවසක	half century
අඩාල	dimidiate
අඩි	feet
අඩිකෝදු	footrule
අඩිතාලම	foundation
අඩිපාර	foot path
අඩිය	foot
අඩු	less
අඩුකම	less
අඩුකමයි	inferiority
අඩුකර	diminish
අඩුක්කර	packing
අඩුකැර	subdued
අඩුකිරීමට	decreasing
අඩුගානේ	atleast
අඩුතරමින්	atleast
අඩුපහඩු	defects
අඩුබර	underweight
අඩුම	less
අඩුමකුඩුම	stuff
අඩුමිලකට	upset price
අඩුමිලට	upset price
අඩුය	is less than
අඩුයි	is less than
අඩුලුහුඬුකම්ය	shortcomings
අඩුලුහුඬුතාව	shortcomings
අඩුව	shortcomings
අඩුවකට	shortcomings
අඩුවක්	shortcomings
අඩුවක්ද	shortcomings
අඩුවකි	shortcomings
අඩුවට	shortage
අඩුවන	decreasing
අඩුවනතුරු	decreasing
අඩුවන්නට	decreasing
අඩුවනු	decreasing
අඩුවැඩිය	implements
අඩුවැඩියක්	implements
අඩුවිමත්	reduced
අඩුවිය	reduced
අඩුවියදමකින්	cheap
අඩුවී	reduced
අඩුවීම	reduced
අණ	command
අණකරුගේ	drawers
අණක්	command
අණදීමේ	command
අණදෙන	command
අණදෙමින්	commanding
අණපණත්වල	precept
අණපනත්	precept
අණපනත්වලින්	precept
අණසක	precept
අණසකට	precept
අණ්වික්ෂයක්	microscope
අණ්වීක්ෂය	microscope
අණ්වීක්ෂයේ	microscope
අණාවරණය	detection
අණින්	command
අණු	atomic
අණුක	molecular
අණුකූල	apropos
අණුකූලව	apropos
අණුව	apropos
අණුවක	molecule
අණුවක්	molecule
අණුවකින්	molecule
අණුවල	molecules
අඬ	noise
අඬගැසීමට	calling
අඬති	cry
ඔබ             you
ඔබගේ      your
අඬදබර	quarrels
අඬදබරවලට	quarrels
අඬනව	cry
අඬනවා	crying
අඬන්න	cry
අඬන්නට	cry
අඬහැරයයි	chevy
අඬා	cry
අඬාපු	cry
අත	hand
අතක	hand
අතකට	hand
අතක්	hand
අතකින්	hand
අතකුත්	hand
අතකොලුවක  mallet
අතගත්	wedded
අතගසන	assists
අතගසා	assist
අතගා	assist
අතගාති	massage
අතගානා	massage
අතගාමින්	massaging
අතගැසීමේ	massage
අතගෑව	massaged
අතට	hand
අතටපත්වීම	handed
අතටය	hand
අතදී	reach
අතදීමක්ද	reaches
අතදෙන	reach
අතන	there
අතනින්	there
අතපත	touch
අතපත්තු	atapattu
අතපත්තුගේ	atapattu
අතපත්තුට	atapattu
අතපත්තුත්	atapattu
අතපය	eagled
අතපයත්	eagled
අතපසු	dilatory
අතපසුවීමකින්	dilatory
අතපාන්න	beg
අතපාන්නට	beg
අතපෙවීම	interfering
අතමයි	hand
අතමිට	means
අතර	between
අතරට	interject
අතරත්	between
අතරතුර	between
අතරතුරදී	between
අතරතුරේ	between
අතරතුරේදිය	between
අතරතුරේදී	between
අතරද	between
අතරදී	between
අතරදීත්	between
අතරදීම	between
අතරම	between
අතරමං	lost
අතරමංව	lost
අතරමංවන	lost
අතරමංවීම	lost
අතරමංවූ	lost
අතරමංවෙලා	lost
අතරමග	in transit
අතරමගකදී	in transit
අතරමගදි	in transit
අතරමගදී	in transit
අතරමගදීය	in transit
අතරමඟ	in transit
අතරමඟදී	in transit
අතරමඟදීම	in transit
අතරමැද	in transit
අතරමැදි	in transit
අතරමැදියන්	intermediary
අතරමැදියා	intermediary
අතරමැදියෙකු	intermediary
අතරමැදිව	intermediary
අතරය	among
අතරයි	among
අතරවාරයේ	ad interim
අතරවාරයේදීයි	ad interim
අතරවාරේ	ad interim
අතරින්	among
අතරින්ද	among
අතරිනුත්	among
අතරෙ	among
අතරෙදි	among
අතරෙදී	among
අතරෙන්	among
අතරෙනුත්	among
අතරෙහි	among
අතරේ	among
අතරේන්	among
අතලොස්ස	handful
අතලොස්සක	handful
අතලොස්සක්	handful
අතලොස්සක්ද	handful
අතවනා	call
අතවර	abusing
අතවරය	abuse
අතවරයකි	abuse
අතවරයට	abuse
අතවරයනට	abuse
අතවරයන්ට	abuse
අතවරවලට	abuse
අතවශ්‍ය	essential
අතවැසියකු	servant
අතවැසියන්ට	servant
අතශයින්	extremely
අතහැර	omission
අතහිත	help
අතළඟ	nearby
අතළඟටම	nearby
අතළඟද	nearby
අතළොස්සකට	handful
අතළොස්සක්	handful
අතළොස්සකි	handful
අතළොස්සෙන්	handful
අත්	hands
අත්අකුරින්	handwriting
අත්අඩංගුව	clutches
අත්අඩංගුවකට	take into custody
අත්අඩංගුවට	take into custody
අත්අඩංගුවේ	take into custody
අත්අඩංගුවේදී	take into custody
අත්ඇරුණම	 miss
අත්ඇරුණාම	miss
අත්කමට	handicraft
අත්කම්	handicraft
අත්ට්‍රැක්ටරයක්	tractor
අත්ත	branch
අත්තක	branch
අත්තක්	branch
අත්තට	branch
අත්තටු	wings
අත්තනගල්ල	aththanagalla
අත්තනගල්ලේ	aththanagalla
අත්තනායක	aththanayaka
අත්තම්මා	grand mother
අත්තම්මෙ	grand mother
අත්තිකාරමක්	advance
අත්තිකාරම්	advance
අත්තිඩිය	aththidiya
අත්තිවාරම	foundation
අත්තිවාරමක්	foundation
අත්තිවාරම්	foundation
අත්තිවාරම්ද	foundation
අත්තෙන්	branch
අත්තේ	branch
අත්දකින	experiencing
අත්දකින්න	experience
අත්දකින්නට	experience
අත්දකීම්	experience
අත්දැකීම	experience
අත්දැකීමකට	experience
අත්දැකීමක්	experience
අත්දැකීමක්ද	experience
අත්දැකීමකි	experience
අත්දැකීම්	experiences
අත්දැකීම්ය	experience
අත්දැකීම්වල	experience
අත්දැකීම්වලින්	experience
අත්දැකීමෙන්	experience
අත්දැකීමේ	experience
අත්දුටු	experience
අත්දුටුවෙමු	experienced
අත්දෙක	hands
අත්නොහරින	retention
අත්නොහළහ	retention
අත්නොහැරියේය	retention
අත්පන්දු	volley ball
අත්පොලසන්	applause
අත්පොළසන්	applause
අත්බෑග	hand bag
අත්බෑග්	hand bag
අත්බෝම්බ	granade
අත්බෝම්බයක්	granade
අත්මිදෙන්නට	prevent
අත්වැරදි	errors 
අත්වැරැද්දක්	errors 
අත්වැරැදීම	errors 
අත්වැරැදීමකින්	errors 
අත්වැල	aid
අත්වැලක්	aid
අත්වැලකින්	aid
අත්වැලට	aid
අත්වැල්	aid
අත්වැසුම්	glove
අත්සන	signature
අත්සන්	signature
අත්සන්තබන	signature
අත්සනින්	signature
අත්හදා	experiment
අත්හදාබැලීම්	experiment
අත්හර	omit
අත්හරවන්න	omit
අත්හරින	omitting
අත්හරින්නේ	omit
අත්හරිනු	omit
අත්හරී	omit
අත්හල	omit
අත්හලේ	omit
අත්හළ	omit
අත්හැර	omit
අත්හැරදමා	omited
අත්හැරවීමේ	omit
අත්හැරීම	omit
අත්හැරීමට	omit
අත්හැරීමෙන්	omit
අත්හැරීමේ	omit
අත්හැරුණම	omit
අත්හිටුවන	suspend
අත්හිටුවන්නැයි	suspend
අත්හිටුවා	suspended
අත්හිටුවි	suspend
අත්හිටුවිය	suspend
අත්හිටුවී	suspend
අත්හිටුවීම	suspending
අත්හිටුවීමට	suspend
අත්හිටුවීමෙන්	suspend
අත්‍යවශ්‍ය	essential
අත්‍යවශ්‍යතම	essential
අත්‍යවශ්‍යතා	essential
අත්‍යවශ්‍යමයි	essential
අත්‍යවශ්‍යය	essential
අත්‍යවශ්‍යයයි	essential
අත්‍යවශ්‍යයි	essential
අත්‍යවශ්‍යයෙන්ම	essential
අත්‍යාතතිය	essential
අත්‍යාවශය	essential
අත්‍යාවශ්‍ය	essential
අතැඟිලි	fingers
අතිරේක	additional
අතිරේකය	additional
අතිරේකව	additional
අතිවිශාල	huge
අතිවිශාලය	huge
අතිවූ	huge
අතිශය	huge
අතිශයින්	huge
අතිශයින්ම	huge
අතිශයෙන්	huge
අතිශයෝක්තියක්	exaggeration
අතිශයෝක්තියට	exaggeration
අතිශයෝක්තියෙන්	exaggeration
අතීත	past
අතීතය	past
අතීතයක	past
අතීතයකට	past
අතීතයක්	past
අතීතයට	past
අතීතයෙන්	past
අතීතයෙහි	past
අතීතයේ	past
අතීතයේදී	past
අතීතයේම	past
අතුගා	sweeping
අතුගෑවී	sweep
අතුගෑවෙන	sweep
අතුරුදන්	disappear
අතුරුදන්ව	disappear
අතුරුදන්වීම	disappear
අතුරුදහන්	disappear
අතුරුදහන්ව	disappear
අතුරුපස	dessert
අද	Today
අදක්ෂ	clumsy
අදටත්	Today
අදත්	Today
අදද	Today
අදපටන්	Today
අදම	Today
අදමේ	Today
අදයි	Today
අදහන	believing
අදහන්න	believing
අදහන්නන්	believing
අදහන්නේ	believing
අදහපු	believing
අදහස	idea
අදහසක්	idea
අදහසකි	idea
අදහසකින්	idea
අදහසකිනි	idea
අදහසට	idea
අදහසත්	idea
අදහසද	idea
අදහසම	idea
අදහසය	idea
අදහසයි	idea
අදහස්	idea
අදහස්කොට	idea
අදහස්ය	idea
අදහස්වන්නේ	idea
අදහස්වල	idea
අදහස්වලට	idea
අදහස්වලින්	idea
අදහසින්	idea
අදහසිනි	idea
අදහසුත්	idea
අදහසෙකි	idea
අදහසෙන්	idea
අදහසෙහි	idea
අදහසේ	idea
අදහා	believing
අදහාගත	believing
අදහාගන්න	believing
අදියර	chapter
අදියරකට	chapter
අදියරක්	chapter
අදියරට	chapter
අදියරයි	chapter
අදියරෙන්	chapter
අදියරේ	chapter
අදියරේදී	chapter
අදුරු	dark
අදුරේ	dark
අධ්‍යක්ෂ	director
අධ්‍යක්ෂක	director
අධ්‍යක්ෂණය	directing
අධ්‍යක්ෂණයේදී	director
අධ්‍යක්ෂතුමා	director
අධ්‍යක්ෂවරයකු	director
අධ්‍යක්ෂවරයා	director
අධ්‍යක්ෂවරයාට	director
අධ්‍යක්ෂවරයෙකි	director
අධ්‍යක්ෂවරයෙකු	director
අධ්‍යක්ෂවරිය	director
අධ්‍යක්ෂවරු	director
අධ්‍යක්ෂවරුන්	director
අධ්‍යක්ෂවරුන්ගෙන්	director
අධ්‍යක්ෂිකා	director
අධ්‍යක්ෂිකාව	director
අධ්‍යක්ෂිකාවක	director
අධ්‍යක්ෂිකාවක්	director
අධ්‍යනය	studing
අධ්‍යනයක්	study
අධ්‍යනයකින්	study
අධ්‍යනයට	study
අධ්‍යනයනය	study
අධ්‍යනයන්ට	study
අධ්‍යපනය	study
අධ්‍යපනයට	study
අධ්‍යයන	study
අධ්‍යයනය	study
අධ්‍යයනයක	study
අධ්‍යයනයකට	study
අධ්‍යයනයකදී	study
අධ්‍යයනයක්	study
අධ්‍යයනයකින්	study
අධ්‍යයනයට	study
අධ්‍යයනයන්	study
අධ්‍යයනයන්ගෙන්	study
අධ්‍යයනයන්ට	study
අධ්‍යයනයෙන්	study
අධ්‍යයනයෙහි	study
අධ්‍යයනයේදී	study
අධ්‍යයනවලට	study
අධ්‍යයනවලින්	study
අධ්‍යාපන	education
අධි	high
අධික	high
අධිකතර	high
අධිකම	high
අධිකය	high
අධිකරණ	law courts
අධිකරණමය	law courts
අධිකරණය	law courts
අධිකරණයක	law courts
අධිකරණයකට	law courts
අධිකරණයක්	law courts
අධිකරණයකින්	law courts
අධිකරණයට	law courts
අධිකරණයටත්	law courts
අධිකරණයන්ට	law courts
අධිකරණයෙන්	law courts
අධිකරණයෙන්ම	law courts
අධිකරණයෙනුත්	law courts
අධිකරණයේ	law courts
අධිකරණයේදී	law courts
අධිකරණවල	law courts
අධිකරණවලට	law courts
අධිතාක්ෂණය	high tech
අධිතාක්ෂණයෙන්	high tech
අධිතාක්ෂණික	high tech
අධිපති	chief
අධිපතිත්වය	chief
අධිපතිතුමා	chief
අධිපතියකු	chief
අධිපතියා	chief
අධිවේගී	Express
අධිශීතකරණ	super cooled
අධිෂ්ඨාන	determination
අධෛර්ය	discouragement
අධෛර්යමත්	discouragement
අධෛර්යයට	discouragement
අධෛර්යවත්ව	discouragement
අනගි	worth
අනතුර	accident
අනතුරක	accident
අනවශ්‍ය	unnecessary
අනවසරයෙන්	unnecessary
අනවසරයෙනි	unauthorized
අන්තර්ජාතික	international
අන්තර්ජාතිකව	international
අන්තර්ජාල	internet
අන්තර්ජාලය	internet
අන්තර්ජාලයට	internet
අන්තර්ජාලයෙන්	internet
අන්තිම	last
අන්තිමට	last
අන්තිමයි	last
අන්තිමේ	last
අන්තිමේදී	last
අන්ධ	blind
අන්ධකාරයට	dark
අන්ධකාරයෙ	dark
අන්ධකාරයෙන්	dark
අන්නාසි	pineapple
අනාගත	future
අනාගතය	future
අනාගතයක්	future
අනාගතයට	future
අනාගතයේ	future
අනාගතයේදි	future
අනාගතයේදී	future
අනාථ	orphan
අනාථකඳවුරු	orphanage
අනාථයන්	orphans
අනාථයි	orphans
අනාථවූවන්ට	orphans
අනාථාගරයකදී	orphans
අනාථාගාරය	orphans
අනාථාගාරයට	orphans
අනාථාගාරයෙන්	orphans
අනාථාගාරයේ	orphans
අනාරක්ෂිත	unprotected
අනුගමනය	imitation
අනුග්‍රහ	sponser
අනුමත	approved
අනුමතයි	approved
අඳුර	dark
අඳුරක්	dark
අපද්‍රව්‍ය	waste
අපද්‍රව්‍යයත්	waste
අපද්‍රව්‍යවල	waste
අපද්‍රව්‍යවලින්	waste
අපනයන	exports
අපනයනකරු	exports
අපනයනකරුට	exports
අපනයනකරුවකු	exports
අපනයනය	exporting
අපනයනයකර	exported
අපනයනයට	exports
අපනයනයන්	exports
අපනයනයෙන්	exports
අපනයනයෙහි	exports
අපරදිග	western
අපරදිගින්	western
අපරාධ	crimes
අපරාධකරු	criminal
අපරාධකරුගේ	criminal
අපරාධකරුන්	criminal
අපරාධකරුවකු	criminal
අපරාධකරුවන්	criminal
අපරාධකරුවන්ගෙන්	criminal
අපරාධකරුවන්ට	criminal
අපරාධකාරයකුට	criminal
අපරාධකාරයන්	criminal
අපරාධකාරයෝ	criminal
අපරාධකාරී	criminal
අපරාධත්	criminal
අපරාධය	criminal
අපරාධයක	criminal
අපරාධයකට	criminal
අපරාධයක්	criminal
අපරාධයක්ද	criminal
අපරාධයකි	criminal
අපරාධයට	criminal
අපරාධයෙකි	criminal
අපරාධවල	criminal
අපරාධවලට	criminal
අපරාධවලටත්	criminal
අපරාධවලින්	criminal
අපහසු	difficult
අපහසුකම්	difficult
අපහසුතා	difficult
අපහසුතාව	difficulty
අපහසුතාවකට	difficult
අපහසුතාවකටම	difficult
අපහසුතාවකින්	difficult
අපහසුතාවට	difficult
අපහසුතාවන්	difficult
අපහසුතාවන්ට	difficult
අපහසුතාවය	difficulty
අපහසුතාවයකට	difficult
අපහසුතාවයක්	difficult
අපහසුතාවයකින්	difficult
අපහසුතාවයට	difficult
අපහසුතාවයන්	difficult
අපහසුතාවයන්ට	difficult
අපහසුතාවයයි	difficult
අපහසුතාවලට	difficult
අපහසුතාවලින්	difficult
අපහසුතාවෙන්	difficult
අපහසුනම්	difficult
අපහසුම	difficult
අපහසුය	difficult
අපහසුයි	difficult
අපහසුව	difficult
අපහසුවක්	difficult
අපහසුවකින්	difficult
අපහසුවට	difficult
අපහසුවයි	difficult
අපහසුවීම	difficult
අපහසුවීමත්	difficult
අපහසුවෙන්	difficult
අපහසුවේ	difficult
අප්‍රියෙල්	April
අප්‍රෙල්	April
අප්‍රේල්	April
අපි	we
අපිට	us
අපිටත්	we
අපිටවත්	we
අපිත්	we
අපිද	we
අපිදු	we
අපිම	we
අපිමයි	we
අපිරිසිදු	dirty
අපිරිසිදුකමත්	dirty
අපිරිසිදුම	dirty
අපිරිසිදුය	dirty
අපිරිසුදු	dirty
අපිරිසුදුතාව	dirty
අපිරිසුදුය	dirty
අපුරු	curious
අපුරුව	curious
අපේකෂිතය	expect
අපේක්ෂ	expect
අපේක්ෂක	candidate
අපේක්ෂකගේ	candidate
අපේක්ෂකත්වයෙන්	candidate
අපේක්ෂකයකු	candidate
අපේක්ෂකයනට	candidate
අපේක්ෂකයන්	candidate
අපේක්ෂකයන්ගේ	candidate
අපේක්ෂකයන්ට	candidate
අපේක්ෂකයනුත්	candidate
අපේක්ෂකයා	candidate
අපේක්ෂකයාගේ	candidate
අපේක්ෂකයාට	candidate
අපේක්ෂකයින්	candidate
අපේක්ෂකයින්ගේ	candidate
අපේක්ෂකයින්ට	candidate
අපේක්ෂකයෙක්	candidate
අපේක්ෂකයෝ	candidate
අපේක්ෂයන්	candidate
අපේක්ෂා	candidate
අපේක්ෂාකරන	candidate
අබ	mustard
අභ්‍යාස	excersice
අභ්‍යාසය	excersice
අභ්‍යාසයක	excersice
අභ්‍යාසයක්	excersice
අභ්‍යාසයකි	excersice
අභ්‍යාසයට	excersice
අභ්‍යාසයත්	excersice
අභ්‍යාසයන්	excersice
අභ්‍යාසයන්ගේ	excersice
අභ්‍යාසයෙන්ද	excersice
අභ්‍යාසයෙහි	excersice
අභ්‍යාසයේ	excersice
අභ්‍යාසලාබී	excersice
අභ්‍යාසලාභි	excersice
අභ්‍යාසලාභීන්	excersice
අභ්‍යාසවල	excersice
අභාග්‍ය	unlucky
අභාග්‍යමත්	unlucky
අභාග්‍යය	unlucky
අභාග්‍යයකට	unlucky
අභාග්‍යයක්	unlucky
අභාග්‍යසම්පන්න	unlucky
අභාවප්‍රාප්ත	late
අභාවප්‍රාප්තවේ	late
අභාවය	late
අභාවයට	late
අභාවයත්	late
අභාවයෙන්	late
අභියේගතා	challenge
අභියෝග	challenge
අභියෝගකාරි	challenging
අභියෝගකාරී	challenging
අභියෝගතා	challenge
අභියෝගය	challenge
අභියෝගයකට	challenge
අභියෝගයකටම	challenge
අභියෝගයක්	challenge
අභියෝගයක්ව	challenge
අභියෝගයකි	challenge
අභියෝගයට	challenge
අභියෝගයනට	challenge
අභියෝගයන්	challenge
අභියෝගයන්ට	challenge
අභියෝගයන්ටත්	challenge
අභියෝගයයි	challenge
අභියෝගවලට	challenge
අභියෝගාත්මක	challenging
අභිරහස	detective
අභිරහස්	detective
අභිරහස්වලින්	detective
අම්ම	mother
අම්මගෙ	mother
අම්මගේ	mother
අම්මට	mother
අම්මටත්	mother
අම්මටයි	mother
අම්මන්	mother
අම්මප	mother
අම්මයා	mother
අම්මයි	mother
අම්මල	mothers
අම්මලගෙ	mothers
අම්මලා	mothers
අම්මලාගේ	mothers
අම්මලාට	mothers
අම්මා	mother
අමාත්‍ය	minister
අමාත්‍යංශ	ministry
අමාත්‍යංශය	ministry
අමාත්‍යංශයක්	ministry
අමාත්‍යංශයට	ministry
අමාත්‍යංශයෙන්ද	ministry
අමාත්‍යංශයේ	ministry
අමාත්‍යංශයේත්	ministry
අමාත්‍යංශවල	ministry
අමාත්‍යතුමා	minister
අමුත්තක්	guest
අමුත්තකු	guest
අමුත්තන්	guest
අමුත්තන්ගේ	guest
අමුත්තන්ට	guest
අමුත්තා	guest
අමුත්තාට	guest
අමුත්තෙක්	guest
අමුත්තෙකු	guest
අමුත්තෝ	guest
අඹ	mango
අයිති	own
අයිතිකර	own
අයිතිකරු	own
අයිතිකරුගේ	own
අයිතිකරුට	own
අයිතිකරුවකු	own
අයිතිකරුවන්	own
අයිය	 brother
අයියට	 brother
අයියයි	 brother
අයියලා	 brothers
අයියලාගේත්	 brothers
අයියලාට	 brothers
අයියා	 brother
අයියාගේ	 brother
අයියාට	brother
අයියාත්	 brother
අයියාව	 brother
අයියෙ	 brother
අයියේ	brother
අර්ථය	meaning
අර්ථයක්	meaning
අර්ථයකින්	meaning
අර්ථයට	meaning
අර්ථයත්	meaning
අර්ථයෙන්	meaning
අර්ථයේ	meaning
අර්ථලාභය	meaning
අර්ථවත්	meaning
අලංකාර	beautiful
අලංකාරකොට	beautiful
අලංකාරම	beautiful
අලංකාරය	beautiful
අලංකාරයක්	beautiful
අලංකාරයට	beautiful
අලංකාරයත්	beautiful
අලංකාරයි	beautiful
අලංකාරයෙන්	beautiful
අලංකාරව	beautiful
අලංකාරවත්	beautiful
අලියකු	elephant
අලියකුගේ	elephant
අලියකුට	elephant
අලියට	elephant
අලියා	elephant
අලියාගේ	elephant
අලියාගේත්	elephant
අලියාට	elephant
අලියෙක්	elephant
අලියෙකු	elephant
අලියෙකුගෙ	elephant
අලිවලිගවල	elephant
අලීන්	elephants
අලු	ash
අලුත්	new
අලෙවිකරණ	marketing
අලෙවිකරණය	marketing
අලෙවිකරණයේ	marketing
අලෙවිකරන්නන්	marketing
අලෙවිකරුවන්ට	marketers
අලෙවිය	marketing
අලෙවියක්	marketing
අලෙවියට	marketing
අලෙවියෙන්	marketing
අලෙවියේ	marketing
අලෙවිසල	market
අලෙවිසල්	markets
අලෙවිසල්වලින්	markets
අලෙවිහල්	markets
අවංක	honest
අවංකකම	honest
අවංකකමට	honest
අවංකකමත්	honest
අවංකත්වය	honest
අවංකභාවයෙන්	honest
අවංකයි	honest
අවංකව	honest
අවංකවම	honest
අවුරුද්ද	year
අවුරුදු	years
අවුල	confusion
අවුලක	confusion
අවුලකට	confusion
අවුලක්	confusion
අවුලට	confusion
අශ්ව	horse
අශ්වයකු	horse
අශ්වයන්	horse
අශ්වයා	horse
අශ්වයාත්	horse
අශ්වයිනට	horse
අශ්වයින්	horses
අශ්වයෙක්	horse
අශ්වයෝ	horses
අස්වන්නට	harvest
අස්වන්නැයි	harvest
අස්වනු	harvests
අහස	sky
අහසක්	sky
අහසට	sky
අහසත්	sky
අහස්	sky
අහසින්	sky
අහිංසක	innocent
අහිංසකකමට	innocent
අහිංසකම	innocent
අහිංසකයකු	innocent
අහිංසකයන්	innocent
අහිංසකයන්ය	innocent
අහිංසකයා	innocent
අහිංසකයාගේ	innocent
අහිංසකයාට	innocent
අහිංසකයි	innocent
අහිංසකයෝ	innocent
අළුත්	new
ආච්චි	grandmother
ආච්චිගෙ	grandmother
ආච්චිගෙන්	grandmother
ආච්චියෙක්	grandmother
ආච්චිලා	grandmothers
ආච්චිලාටත්	grandmothers
ආච්චී	grandmother
ආඩම්බර	proud
ආඩම්බරකාර	proud
ආඩම්බරය	proud
ආඩම්බරයක්	proud
ආඩම්බරයකි	proud
ආඩම්බරයට	proud
ආඩම්බරයෙන්	proud
ආඩම්බරයෙනි	proud
ආඩම්බරෙන්	proud
ආණ්ඩුව	government
ආදරය	love
ආදරවන්තයන්	lover
ආදරවන්තයන්ගේ	lover
ආදරවන්තයන්ට	lover
ආදරවන්තයාව	lover
ආදරවන්තියන්ට	lover
ආදායම	income
ආදායමක්	income
ආදායමකි	income
ආදායමකුත්	income
ආදායමට	income
ආදායමත්	income
ආදායමයි	income
ආදායම්	income
ආයතනයය	company
ආරක්ෂක	security
ආරක්ෂිත	secure
ආරෝග්‍යශාලා	hospital
ආරෝග්‍යශාලායීය	hospital
ආරෝග්‍යශාලාවලින්	hospital
ආලෝක	light
ආලෝකරණය	lighting
ආසනවල	seat
ආසනවලින්	seat
ආසනවලින්	seat
ආසන්න	near
ආසයි	desire
ආස්වාද	enjoying
ආසාදන	infection
ආසියා	asia
ආසියාතික	asian
ආහාර	foods
ආහාරවේල	meal
ඇගයීම	evaluation
ඇගිලි	fingers
ඇඟ	body
ඇඟලුම්	garments
ඇඟවීම	implication
ඇඟැලුම්	attachment
ඇඟිල්ල	fingers
ඇට	seeds
ඇටකටු	bones
ඇටමිඳුළු	marrow
ඇටසැකිල්ල	skeleton
ඇටිකුකුලා	crow pheasant
ඇණ	nail
ඇණවුම්	order
ඇණහිටිනු	failure
ඇඬුවා	cry
ඇත	have
ඇතමුන්	somebody
ඇත්	elephant
ඇත්ගොව්වා	mahout
ඇත්ත	TRUE
ඇත්දළ	ivory
ඇතැම්විට	sometimes
ඇතිල්ලීම	rub
ඇතිලි	pan
ඇතිවුණා	happen
ඇතුලට	inside
ඇතුල්වුණා	enter
ඇද	curved
ඇදවැටී	collapse
ඇදහිල්ල	belief
ඇදුම	asthma
ඇදුරකු	teacher
ඇනකොටාගන්න	fight
ඇනවුම	order
ඇනහිට	conkout
ඇන්ජින්	engine
ඇඳ	bed
ඇඳිරි	darkness
ඇඳිරිනීතිය	curfew
ඇඳුම	dress
ඇප	bond
ඇපකරු	guarantor
ඇබ්බැහි	habitual
ඇබෑර්තු	vacancy
ඇමති	minister
ඇමතුම	call
ඇමිණිය	meshed
ඇමුණුවා	clipped
ඇඹරී	crushing
ඇඹුල්	sour
ඇය	she
ඇයි	why
ඇර	open
ඇරත්	otherwise
ඇරඹිණ	start
ඇරයුම	invitation
ඇල	bank
ඇලවීම	nap
ඇල්ම	like
ඇල්ලුවා	touch
ඇවිද	walk
ඇවිස්සීම	excitement
ඇස	eye
ඇසළ	july
ඇසිණ	listened
ඇසුර	associate
ඇසුරිණි	packed
ඇසුරුම	packed
ඇසුව	hear
ඇහැ	eye
ඇහැරීමට	wakeup
ඇහිඳ	pick
ඇහිබැම	eyebrow
ඇළ	stream
ඈ	she
ඈත	far
ඈත්	distant
ඉංග්‍රිසි	enlish
ඉංජිනේරු	engineer
ඉක්බිත්තෙන්	then
ඉක්මණට	quick
ඉක්මවති	exceed
ඉකුත්	expire
ඉකුත්දා	yesterday
ඉගැන්නුවා	taught
ඉගිල	fly
ඉගෙන	learn
ඉඟි	hints
ඉඟුරු	ginger
ඉච්ඡා	hope
ඉටි	wax
ඉටිපන්දමක්	candle
ඉටුකර	achieve
ඉඩ	space
ඉඩම	land
ඉණිමං	ladder
ඉණිමෙන්	inning
ඉණෙහි	hip
ඉතසිතින්	hartiest
ඉත්තක්	sprig
ඉත්තැවා	porcupine
ඉතා	very
රසයි             tasty
ඉතිං	so
ඉතික්බිතිව	then
ඉතින්	so
ඉතිරි	save
ඉතිරී	overflow
ඉතිහාස	history
ඉතුරු	balance
ඉදිකටුවක්	needle
ඉදිකර	build
ඉදිමීම	bump
ඉදිරි	front
ඉදිරිකාලය	forward
ඉදිරිපත්	adducent
ඉදිරිපස	presence
ඉදිරිපිට	before
ඉදිවන	constructing
ඉදුණිල්	sapphire
ඉදුණු	mellow
ඉදුරා	definitely
ඉදෙන	riping
ඉනට	hip
ඉන්	thereby
ඉන්ජිනේරු	engineer
ඉන්ද්‍රියන්	organ
ඉන්දිය	indian
ඉන්ධන	fuel
ඉන්න	stick
ඉන්පස්සේ	thereafter
ඉන්පසු	thereafter
ඉනි	
ඉනික්බිති	afterward
ඉනිම	inning
ඉඳගන්නට	sitting
ඉඳිආප්ප	string hoppers
ඉඳුනිල්	sapphire
ඉඳුරා	definitely
ඉපදිණි	born
ඉපනැල්ල	stubble
ඉපයීම	earning
ඉපැරණි	Age-old
ඉබ්බන්	tortoises
ඉබේ	automatically
ඉමහත්	extraordinary
ඉමිහිරි	honeyed
ඉර	Sun
ඉරණම	fate
ඉරනවද	rip
ඉරි	stripes
ඉරිගු	corn
ඉඟුරු	ginger
ඉරිතලා	cracking
ඉරිදා	Sunday
ඉරියව්	postural
ඉරීම	ripping
ඉරුණු	ripping
ඉලක්ක	target
ඉලක්කම්	numbers
ඉලන්දාරියා	youth
ඉල්ලති	applying
ඉල්ලම්	outcrop
ඉල්ලීම	applying
ඉල්ලුම්කරු	applicant
ඉල්ලුම්පත්	applications
ඉලෙක්ට්‍රොනික	electronic
ඉව	trail
ඉවත	away
ඉවර	finish
ඉවසන්න	patience
ඉවහල්	helpful
ඉවුම්	cuisine
ඉවුර	shore
ඉෂ්ට	desired
ඉස	
ඉසව්ව	direction
ඉස්කුරුප්පු	screw
ඉස්කෝල	school
ඉස්තරම්	best
ඉස්පාසුවක්	leisure
ඉස්පිරිතාලෙ	hospital
ඉස්මත්තෙන්	
ඉස්ලාමය	islam
ඉස්සන්	prawns
ඉස්සර	previously
ඉස්සරහ	front
ඉස්සීමක්	bearing
ඉස්සෙල්ල	first
ඉසිලීමට	bearing
ඉහත	above
ඉහල	above
ඊට	thereto
ඊටපසු	thereafter
ඊතල	arrows
ඊමේල්	email
ඊයක	arrow
ඊයම්	lead
ඊයෙ	yesterday
ඊයේ	yesterday
ඊර්ෂ්‍යා	jealouse
ඊර්ෂ්‍යාව	jealouse
ඊර්ෂ්‍යාවකින්	jealousy
ඊලඟ	next
ඊලඟට	next
ඊශාන	northeast
ඊශානදිග	northeast
ඊසාන	northeast
ඊළග	next
ඊළඟ	next
උකස	mortgage
උකහා	dragging
උක්ගස්	suger canes
උක්ත	mentioned
උකුණන්	lice
උකුල්	hips
උකුස්සකු	eagle
උකුළේ	hip
උගත	educated
උගන්වනවා	teaching
උගස්	mortgaging
උග්‍ර	critical
උගැන්ම	teaching
උගැන්මකින්	teaching
උගුර	throat
උගුල්	trap
උගෙ	its
උගේ	its
උච්ච	high
උච්චාරණය	pronounciationing
උච්චාවචනයද	fluctuating
උචිත	suitable
උජාරු	dashing
උට්ඨාන	rising
උඩ	up
උඩරට	upcountry
උඩවැඩියා	orchid
උඩින්	up
උඩුකය	bust
උඩුකුරු	orthotropic
උඩුබැලි	supine
උඩුමහල්වල	upstairs
උඩුයටිකුරු	orthotropic
උණ	fever
උණගස්	bamboo
උණ්ඩ	ammunition
උණු	warm
උණුකිරීම	fusion
උණුවතුර	hotwater
උණුසුම	heat
උත්කර්ෂවත්	dignified
උත්කෘෂ්ට	adorable
උත්තම	excellent
උත්තර	boreal
උත්තරීතර	super
උත්තරීතරම	super
උත්තල	convex
උත්තේජක	stimuli
උත්පත්ති	birth
උත්පාදක	generative
උත්පාදන	proceeds
උත්සන්න	elevated
උත්සව	ceremonial
උත්සහ	attempting
උත්සුක	anxious
උතුමන්	chief
උතුම්	best
උතුර	north
උතුරන	boiling
උතුරුමැද	boreal
උදම්	tidal
උදය	morning
උදර	belly
උදරය	stomach 
උදලු	hoes
උදව්	help
උදවිය	people
උදවු	help
උදහරණයක්	egsample
උදහස	anger
උදළු	hoes
උද්ගත	risen
උද්ඝෝෂකයකු	Agitator
උද්ඝෝෂණ	agitation
උද්දාම	exaltation
උද්ධච්ඡ	popinjay
උද්ධමනයට	Inflation Inspiring 
උද්භිද	Botanical
උද්යෝගයක්	 Enthusiasm 
උද්යෝගිමත්	Enthusiastic 
උද්වේගකර	Inspiring
උද්‍යාන	park
උදාරය	great
උදාරහරණයක්	example
උදාහරණ	examples
උදැල්ල	mamoty
උදෑසන	Morning
උදුන්	cookers
උදුරගෙන	away from
උදෙසා	for
උනන්දුව	Interests
උන්ගේ	Their
උඳු	gram
උඳුනක	cooker
උඳුවප්	December
උප	vice
උපකරණ	equipment
උපකල්පන	assumption
උපක්‍රම	tactic
උපකාර	help
උපත	birth
උපද්‍රව	hazard
උපදෙස්	instruction
උපදේශ	advisor
උපන්	birth
උඩ	above
පිටරට	abroad
රට	abroad
පිළිගන්නවා	accept
අනතුර	accident
හරහා	across
ලිපිනය	address
වැඩිහිටි	adult
අහස්යානය	aeroplane
පසුව	after
ඊලඟට	after
නැවත	again
විරුද්දව	against
වයස	age
කලහක්කර	aggressive
එකඟයි	agreed
වාතය	air
සියල්ල	all
ඔක්කොම	all
අවසර දිම	allows
තනිව	alone
අතර	among
සහ	and
සතුන්	animals
නිවැරදියි      correct
අප්‍රියෙල්	april
අත	arm
ඊය	arrow
අගෝස්තුව	august
නැන්ද	aunt
ළදරුවා	baby
ආපසු	back
නරක	bad
නපුරු	bad, cruel
ගහනවා	beating
පහර	beat
ලස්සණ	beautiful
රූපය	beauty
කලින්	before
ඉස්සර	before
යට	under
කුරුල්ලා	bird
උපන් ගම	birthplace
ලේ	blood
ඇඟ	body
කොල්ලා	boy
නමුත්	but
නගරය	city
පිරිසිදු	clean
පිරිසිදුකරනවා	cleaning
වහනවා	closeing
කෝපි	coffee
රට	country
දෙන	cow
දෙන්නු	cows
කපුටා	crow
කපුටෝ	crows
කපනවා	cutting
කැපුව	cut
මරණය	death
දෙසැම්බරය	december
මල	dirt
අපිරිසිදු	dirty
රෝගය	disease
බල්ලා	dog
පදිංචිය	domicile
දොර	door
සැකය	doubt
සිහිනය	dream
කන	ear
ඈත පෙරදිග	East Asia
කනවා	eating
අට	eight
ඇස	eye
මූණ	face
ඈත	far
ගොවිපළ	farm
ඉක්මන්	fast
පෙබරවාරි	february
උණ	fever
ඇඟිල්ල	finger
මාළුවා	fish
පහ	five
මල	flower
කකුල	foot
ගෑරුප්පුව	fork
හතර	four
සිකුරාදා	friday
මැණික	gem
කණ්ණාඩි කුට්ටම	glasse
හොඳ	good
නැවත හමුවෙමු	Good bye
රජය	government
ආතා	grandfather
ආච්චී	grandmother
කෙස්	hair
සුබ උපන්දිනයක්	Happy Birthday
තද	hard
එයා	he
ඔළුව	head
සනීප	health
සැප	health
හදවත	heart
රස්නය	heat
ආයුබෝවන්	Hello
කිකිළී	hen
මෙහෙ	here
ගෙදර	home
අශ්වයා	horse
අශ්වයෝ	horses
රෝහල	hospital
රස්නේ	hot
ගෙය	house
ගෙවල්	houses
කොහොමද	how
කොච්චර	how
එකසීය	hundred
සීය	hundred
රිදෙනවා	hurt
මම	I
නේ	isn't it?
ජනවාරිය	january
ජූලි	july
ජූනි	june
මරනවා	killing
රජ	king
කුස්සිය	kitchen
පිහිය,පිහි	knife
ඊයම්	lead
දිවියා	leopard
ලියුම	letter
එළිය	light
සිංහය	lion
ආදරය	love
මිනිහා	man
මිනිසා	man
මාර්තුව	march
මැයි	may 
මතකය	memory
මිනිස්සු	men
කිරි	milk
මනස	mind
මගේ	mine
මිනිත්තුව	minute
සඳුදා	monday
සල්ලි	money
වඳුරා	monkey
මාසය	month
මීයා	mouse
කට	mouth
නම	name
සෘණ	negative
ආරම්භවේ	beginnings
නව	new
රැය	night
නවය	nine
නැහැ	no
එපා	not
නොවැම්බරය	november
ඔක්තෝබරය	october
කන්තෝරුව	office
අය්යා	older brother
අක්කා	older sister
උඩ	on
එක	one
සාමය	peace
ඍතුව	period, season
ඌරා	pig
ඌරෝ	pigs
කරුණාකර	please
ඌරු මස්	pork
තැපෑල	post office
ඔබනවා	pressing
පලාත	province
කාල	quater
වහිනවා	raining
වැස්ස	rain
මීයා	rat
රතු	red
දිසාව	region
පොහොසත්	rich
පොහොසතා	rich man
පොහොසතී	rich woman
හරි	right 
ගඟ	river
දුවනවා	running
පඩිය	salary
සම	same
ගායනා කළා	sang
සාරිය	sari
සෙනසුරාදා	saturday
කතුර	scissors
රහස	secret
යවනවා	send
සැප්තැම්බරය	september
හත	seven
සපත්තුව	shoe
කෙටි	short
රිදී	silver
ගයනවා	singing
සිංහල	sinhalese
හය	six
මිටි	low
අනවශ්‍ය	unimportant
කුඩා	small
හිනාවෙනවා	smileing
හිම	snow
දකුණු	south
හැන්ද	spoon
ක්‍රීඩාව	sport
ගල	stone
සීනි	sugar
ඉර	sun
ඉරිදා	sunday
මිහිරි	sweet
මේසය	table
මේසය	table
ගන්නවා	taking
උස	tall
ටැක්සිය	taxi
කියත	saw
ඉරනවා	tearing
දත්	teeth
ටෙලිෆෝනය	telephone
පන්සල	temple
දහය	ten
බොහොම ස්තුතියි	thanks
ස්තුතියි	thank you
ස්තුති	thanks
තරබාරු	corpulent
දැඩි	strong
තර	thick
දෙය	thing
දේවල්	things
හිතනවා	thinking
ඒක	this
කල්පනාව	thought
දහස	thousand
තුන	three
බ්‍රහස්පතින්දා	thursday
කල	time
කාලය	time
චූටි	tiny
ඉන්නවා	to be
පිරිසිදු 	cleaning
එනවා	coming
උයනවා	cooking
කරනවා	doing
ගියා	went
රිදෙනවා	hurts
දන්නවා	knows
මතක්වෙනවා	remember
ටෙලිෆෝන් කරනවා	telephone
හෝදනවා	washing
වැඩ කරනවා	working
අද	today
දිව	tongue
දත	tooth
සත්‍යය	truth
දෙක	two
මාමා	uncl
ගම	village
මිනිත්තුවක්	minute
වතුර	water
අපි	we
බදාදා	wednesday
සතිය	week
දියුණුව	well being
මොකක්ද	what
කොහේ	where
කොයි	which
සුදු	white
කව්ද	who
ඇයි	why
සුළඟ	wind
කෙල්ල	woman
වැඩ 	work
ඈනුම් අරිනවා	yawning
අවුරුද්ද	year
අවුරුදුපතා	yearly
ඔවු	yes
ඊයේ	yesterday
ඔයා	you
මල්ලි	younger brother
නංගි	younger sister
ස්වභාවය	nature
ස්වභාවික	Natural
ස්වයං	Self
ස්වයංක්‍රීයව	Automatically
ස්වයංපෝෂිත	Sufficiency
ස්වයංරැකියාවක්	Self
ස්වරය	Tone
ස්වර්ගය	Heaven
ස්වර්ණාභරණ	jewelery
ස්වරුපය	Uniformity
ස්වල්පය	Little
ස්වාධීන	Independent
ස්වාභාවික	natural
ස්වාමිපුරුෂයා	Husband
ස්වාමියා	Master
ස්වේච්ඡාවෙන්	Volunteering
සාංඝික	Community
සාංස්කෘතික	Cultural
සාකච්ඡාව	dicussion
සාක්කි	Evidence
සාක්කුව	Pocket
සාක්ෂරතාව	Literacy
සාක්ෂි	Evidence
සාක්ෂිකරු	Witness
සාගරය	Ocean
සාදන	Made
සාධකය	Factor
සාධනය	Performance
සාධාරණය	Justice
සාන්ද්‍රනය	Concentration
සානුකම්පිත	Compassionate
සාපය	Cursing
සාප්පුව	Shop
සාපේක්ෂව	Relatively
සාම	Peace
සාමය	peace
සාම්පල	Sample
සාම්ප්‍රදායික	traditional
සාමාජිකත්වය	Membership
සාමාජිකයා	Member
සාමාන්‍ය	general
සාමාන්‍යාධිකාරී	General
සාමාර්ථ	Passes
සාමූහික	Collective
සායම්	Dyes
සාරධර්ම	Values
සාරය	The essence
සාරවත්	Fertility
සාර්ථක	success
සාරාංශය	Summary
සාහිත්‍ය	Literature
සැක	Suspect
සැකකරු	Suspect
සැකකාර	Suspect
සැකසූ	Processed
සැකිල්ල	Template
සැඟවී	Hiding
සැඟවුණ	Hidden
සැටි	How
සැණකෙළිය	Carnival
සැණින්	Immediately
සැත්කම	Surgery
සැතැපුම්	Miles
සැනකෙළිය	Festival
සැනසීම	Comfort
සැනසුම	Thing
සැඳෑව	Evening
සැප	Comfortable
සැපයුම්	Supplies
සැපයුම්කරුවා	Supplier
සැපයූ	Provided
සැපසම්පත්	Overachieving
සැබෑ	Real
සැම	All
සැමරීම	Celebration
සැමියා	Husband
සැරිසැරීම	Surfing
සැලකිලි	Treatment
සැලකිලිමත්	Concerned
සැලසුම්	planning
සැලසුම්කරුවකු	Planner
සැලසුම්කළ	Planned
සැලැකිලි	Zwart
සැලැස්ම	Plan
සැලැස්වීම	Make
සැසඳීම	Comparison
සැහැල්ලු	Light
සැළකීම	Discrimination
සැළැසුම්	Focusing
සෑදීම	Create
සෑදෙන	Form
සෑම	all
සිංහල	Sinhala
සිංහලයා	Sinhalese
සිකුරාදා	Friday
සිඝ්‍රව	Rate
සිඟිති	Search
සිත	Heart
සිතමින්	Thinking
සිත්තම	Fardeen
සිතියම	Map
සිතිවිලි	Thoughts
සිතුවම	Picture
සිතුවිලි	Thoughts
සිද්ධස්ථාන	Places
සිද්ධාන්තය	Theory
සිදුර	Hole
සිදුවීම	Event
සිනමාව	Cinema
සිනමාහල	Theater
සිනාව	Smile
සිනාසීම	Laughing
සිනිඳු	Smooth
සිමාවන්	Limits
සිමාවී	Limited
සිඹගෙ	Greet
සියපත	Siyapatha
සියලු	all
සියලුම	all
සියවස	Century
සියළුම	All
සියුම්ව	Smoothly
සිරකරු	Prisoners
සිරගෙය	Prison
සිරදඬුවම්	Jail
සිරවීම	Stalemate
සිරස	Sirasa
සිරස්	Vertical
සිරිත්	Customs
සිරිපතුල	Sairaipataula
සිරියාව	Syria
සිරුර	Body
සිල්වත්	Virtuous
සිලින්ඩරය	Cylinder
සිව්පාවුන්	Cattle
සිවිලීම	Ceiling
සිවුපාවෝ	Cattle
සිවුරු	Robes
සිසිල්බීම	Soft
සිසිල්ව	Cool
සිසුන්	students
සිහිකිරීම	Memory
සිහින	Dreams
සිහිපත්	Remember
සිහිමූර්ඡා	Saihaimaūrachaā
සිහිය	Consciousness
සිහිවටනය	Monument
සිහිසුන්	Unconscious
සීඝ්‍රතාවය	Rate
සීඝ්‍රයෙන්	Rapidly
සීතල	Cold
සීමාව	Limit
සීමිත	limited
සීයා	Grandfather
සීරුමාරු	Adjusting
සුත්‍රය	Formula
සුද්දෝ	Tourists do
සුදානම්	Ready
සුදුසුකම	Qualification
සුදුළූණු	Garlic
සුනඛයා	Dog
සුන්දරත්වය	Beauty
සුන්දරයි	Beautiful
සුපරීක්ෂාකාරී	Cautious
සුප්‍රසිද්ධ	Famous
සුපිරි	Super
සුපිරිසිදු	Cleaner
සුපුරුදු	Usual
සුභඵල	Reshuffle
සුමානය	week
සුරකිනවා	Guarding
සුරගංනා	Angel
සුරඟනන්	Angels
සුරත	hands
සුරතල්	Pet
සුරතලා	pet
සුරාව	Liquor
සුරැකිව	Preserved
සුලභව	Common
සුවකළ	Cure
සුවඳ	Perfume
සුවපහසු	Comfortable
සුවවීම	Recovery
සුවිශේෂි	Unique
සුවිසාල	Taxed
සුසුම්	Sigh
සුහඳ	Friendly
සුළඟ	Wind
සුළිසුළඟ	Hurricane
සුළු	Small
සුළුතරය	Minority
සූක්ෂම	Sophisticated
සූත්‍රය	The formula
සූදානම්	Ready
සූදුව	Gambling
සූපවේදියා	Chef
සූරාකෑම	Exploitation
සෘජුව	Directly
සෙනඟ	People
සෙනසුරාදා	Saturday
සෙන්පතියා	Wilmer
සෙනෙහස	Affection
සෙබළා	Soldier
සෙම්ප්‍රතිශ්‍යාව	Colds
සෙමින්	Slowly
සෙරෙප්පු	Slippers
සෙවනැල්ල	Shadow
සෙවනේ	The shade
සෙවිල්ලෙන්	Alert
සෙවිලි	Roofing
සෙවීම	Search
සේදීම	washing 
සේනාංකය	Div
සේනාව	Sena
සේප්පුවේ	Safe
සේලලම්	Sports
සේවකයෝ	Servants
සේවාදායකයා	Client
සේවාවන්	services
සේවිකාව	Hostess
සෛල	cells
සොඬය	Trunk
සොඳුරු	Bright
සොබාදහම	Nature
සොම්නස	Pleasure
සොරබඩු	Burglary
සොරාගෙන	Stolen
සොරුන්	Thieves
සොරොව්ව	Aru
සොල්දාදුවෝ	Soldiers
සොහොන්	Cemetery
සොහොන්බිමක්	The graveyard
සොහොයුරියන්	Sisters
සොහොයුරෝ	Brothers
සෝදන	Washing
සෝදාපාළුවෙන්	Erosion
සෝදිසිය	Watching
සෞඛ්‍ය	Health
සෞඛ්‍යාරක්ෂිත	Healthy
සෞන්දර්යය	Aesthetic
සෞභාග්‍ය	Prosperity
සෞම්‍ය	Temperate
සෞරග්‍රහ	Solar
හංදිය	Junction
හංසයන්	Swans
හට්ටිය	Pot
හඬයි	Voice
හඬේ	Voice
හත	Seven
හතර	four
හතරැස්	Square
හතලිහ	Forty
හතු	Mushrooms
හතුරා	Enemy
හදනවා	Trying
හදවතට	Heart
හදාගෙන	Making
හදාරයි	Learning
හදිසියේම	Suddenly
හදුනාගත්	Identified
හන්දිය	Junction
හනික	Hastily
හඳ	Moon
හඳුනාගෙන	Identified
හඳේ	Moon
හමට	skin
හමුදාව	Army
හමුවීමි	Meeting
හමුවුණු	Met
හමුවෙලා	McIntosh
හය	six
හයදාහක	Millenniums
හයවන	sixth
හරකා	Buffalo
හරඹය	fight
හරය	Core
හරසර	Honors
හරස්කඩ	cross section
හරස්කර	Blocking
හරහා	Through
හරිත	Green
හරිතවර්ණ	Luscious
හරිතාගාර	Greenhouse
හරියට	Like
හවඩිය	Havaḍaiya
හවස	Evening
හවුල්	Share
හවුල්කරුවන්	Partners
හවුල්කාර	Partner
හසරැල්ල	Smiles
හසළ	Expert
හස්තය	Hand
හසුන්පතක්	Hasaunapataka
හසුනොවී	Pravartika
හසුරුවන්නා	Handler
හසුරුවා	Handled
හසුවීම	Place
හාත්පස	Abound
හාද්දක	Kiss
හානිදායක	Harmful
හානිය	Damage
හාමතේ	Starve
හාම්පුතා	Employer
හාමුදුරුවො	Thera
හාරනවා	Digging
හාරසිය	Hundred
හාල්	Rice
හාවා	Rabbit
හාස්කම්	Miracles
හාස්‍ය	Humor
හාස්‍යජනක	Hilarious
හැකියාව	ability
හැකියි	may
හැකිලෙන	Shrinking
හැකිවීම	Ability
හැඟීම්	Feelings
හැඟීම්බර	Emotion
හැඟීමෙන්	Feeling
හැඟුම්	Newsroom
හැඟුම්බර	Slot
හැඟෙනා	Comeback
හැට්ටය	Snare
හැටි	How
හැඩ	Shapes
හැඩකාර	Stylish
හැඩතල	Format
හැඩය	Shape
හැඩරුව	Appearance
හැඩැති	Shaped
හැඬීම	Weeping
හැත්තෑව	SEVENTY
හැතැප්ම	Mph
හැදෑරීම	Follow
හැදි	Tablespoons
හැදිච්ච	Newborn
හැදින්විය	Introduce
හැදියාව	Upbringing
හැදෙන	Polyarthritis
හැන්ද	Spoon
හැන්දෑව	Afternoon
හැඳින්වීම	Introduction
හැඳුනුම්	ID
හැඳුනුම්පත	ID
හැපීම	Bite
හැපෙමින්	Crowding
හැබෑව	 true
හැමතැනම	Everywhere
හැමදාම	Every day
හැමදෙනා	Eager
හැමදේම	Everything
හැමවිට	Always
හැමෝම	Everyone
හැරමිටි	Crutches
හැරීම්	Twists
හැරුණු	Except
හැලුනා	Dropped
හැසිරීම	Behavior
හැසිරුණා	Improper
හැළීම	It drinks
හෑරීම	Hunting
හෑරුණු	Crate
හිංසනය	Violence
හිංසාව	Oppression
හික්මීම	Discipline
හිඟන්නා	Beggar
හිඟය	Deficit
හිඟවීම	Inadequate
හිඟාකෑම	Beg
හිටගෙන	Standing
හිටිහැටියේ	Overnight
හිටෙව්වා	Haiṭaevavaā
හිඩැස	Gap
හිඩැසක	Fissure
හිතකර	Healthy
හිතකාමී	Friendly
හිතට	Heart
හිතමිතුරු	Friend
හිතල	Thought
හිතවත්කම	Friendship
හිතවතුන්	Friends
හිතවාදී	Pro
හිතුමතේ	Capriciously
හිතුවක්කාර	Headstrong
හිතෙනවා	Feel
හිත	Heart
හිදගෙන	Sitting,
හිදැස	Gap
හින්දි	Vietnamese
හිනාව	Smile
හිනාවන්න	Laugh
හිඳගෙන	Sat
හිම	Snow
හිමිකරු	Owner
හිමිකාරත්වය	Ownership
හිමිදිරි	Early
හිමිනම	Monk
හිමින්	Slower
හිමිපාණන්	Thera
හිමියෝ	Thera
හිමිවීම	Imposition
හිරකරුවෝ	Prisoners
හිරගෙදර	Prison
හිරමනය	Hiram
හිරවීම	Asphyxiation
හිරිකඩ	Disgusting
හිරිහැර	Bullying
හිරු	Sun
හිරුඑළිය	Sunlight
හිරුනැගෙන	 sunrise
හිරුබැස	sunset
හිරේ	Prison
හිසරදය	Headache
හිස්ව	Blank
හිස්වැස්ම	Helmet
හීනමානය	Inferiority
හීනය	Dream
හීය	Haīya
හුගාක්	Tired
හුදෙකලාව	Isolation
හුඹස	After
හුරතල්	Cute
හුරුපුරුදු	Familiar
හුරුබුහුටි	Cute
හුරුව	Acclimatised
හුවමාරුව	Exchange
හුස්ම	Breathing
හුළං	Inflatable
හෘදය	Heart
හෘදයවස්තුවට	Heart
හෘදයාබාධ	heart disease
හෘදරෝග	cardiology
හෘදරෝග වෛද්‍යවරයා	cardiologist
හෘදස්පන්දනය	heart beat
හෙට	Tomorrow
හෙණ	Fireballs
හෙණ්ඩුව	ball
හෙදකම	Nursing
හෙදිය	Nurse
හෙබවීම	Even in
හෙම්බත්ව	Weary
හෙම්බිරිස්සාව	Cold
හෙමින්	Slowly
හෙල්ල	Javelin
හෙවන	Partial shade
හෙළ	Hela
හෙළාදකින	Condemned
හෙළිවෙයි	Revealed
හේතුව	Reason
හේදිලා	Washed
හේන්	Chena
හොට	Beak
හොඬවැල	trunk
හොඳහිත	Goodwill
හොඳාකාරව	Smarter
හොඳි	Well
හොඳින්	well
හොබවා	Fiji
හොම්බ	Muzzle
හොයාගෙන	Search
හොරකම	Theft
හොරා	Cheats
හොරු	Thieves
හොල්මන්	Haunted
හෝටල්	Hotel
හෝඩුවාව	HINT
හෝදන්න	Wash
හෝමෝන	Hormones
හෝරා	Time
හෝරාව	Hour
ළඟ	nearby
ළඟදිම	Biomechanics
ළඟාවනු	Reach
ළඟාවිම	Reach
ළඟින්	Close
ළතෝනිය	Groan
සප්පුසවාරි	Shopping
ළමයි	Children
ළඳුන්	Frescos
ළපටි	Juveniles
ළබැඳි	Emphasising
ළමයා	Boy
ළමයි	Children
ළමාරක්ෂක	Child Care
ළමාරෝග	Pediatric
ළමාවිය	Childhood
ළමුන්	Children
ළය	Chest
ළයාන්විත	Loving
ළාබාල	Young
ළැදි	Loving
ළිඳ	Well
ළිප	cooker
ළියක	woman
ළූනු	Onion
සහකාරිය	Companion
සහජ	Instinct
සහජීවනය	Coexistence
සහතික	Certificate
සහන	Relief
සහනය	Comfort
සහනාධාරය	Subsidy
කොටස	Part
සහභාගීත්වය	Participation
සහමුලින්	Completely
සහයෝගීතාව	Cooperation
සහල්	Rice
සහායකයා	Assistant
සහායවීම	Assisting
සහිත	With
සහෘද	Loyalty
සහෝදරයා	Brother
සළකනවා	Sena
සළුව	Coat
ස්කන්ධය	Mass
ස්ත්‍රික්ක	Irons
ස්ත්‍රීය	Lady
ස්තූතියි	Thanks
ස්තූප	Stupas
ස්ථරය	Layer
ස්ථානය	Station
ස්ථායි	Stable
ස්ථාවරය	Stance
ස්ථීර	Permanent
ස්ථූප	Stupas
ස්ථූල	Etc. It
ස්නායු	Nervous
ස්නේහනයක්	Affection
ස්පන්දනය	Pulse
ස්පර්ශ	Contact
ස්පර්ශව	Contact
ස්මාරකය	Monument
ස්වකීය	Own
ස්වදේශ	Home
ස්වදේශිකයා	Indigenous people
ස්වදේශීය	Native
ස්වභාවධර්මය	Nature
සමාරම්භක	Inauguration
සමිතිය	Society
සමීක්ෂණය	Survey
සමීපව	Close
සමුගෙන	Bye
සමුද්‍රය	Samudra
සමුළුව	Conference
සමූහ	Group
සමූහය	Group
සමෘද්ධිය	Prosperity
සමේ	Skin
සයිකලය	Bike
සයුර	Ocean
සරණ	Refuge
සරණාගත	Refugee
සරදම	Ironically
සරම	Anam
සරල	simple
සරසවිය	University
සරසා	Decorated
සරසුල	Sarasaula
සරළ	Traditional
සර්	Sir
සර්පයා	Snake
සර්ව	All
සලකා	Consideration
සලකුණු	Marked
සලසා	Provided
සල්ලි	Money
සල්ලිකාර	Ubai
සවන්	Listen
සව	animated
සවාරිය	Shopping
සවිකිරීම	Fixing
සවිය	Health & Fitness
සවිස්තරාත්මක	Detailed
සසඳන	Compared
සසල	Ego
සහ	And
සහකරු	Partner
සහකාර	Assistant
සන්ධීය	Federal
සන්නද්ධ	Armed
සන්සුන්	Calm
සනීප	Recovery
සඳහන්	mentioned in
සඳහා	For
සඳු	Mon
සඳුඳා	Monday
සපත්තු	Shoes
සපයන	Provided
සපයා	Provided
සපිරි	Super
සපුරාලීම	Meet
සඵලතාව	Mobility
සබඳතා	relations
සභාපතිවරයා	Chairman
සභාවේ	congregation
සමකාලීන	Contemporary
සමග	With
සමගාමී	Concurrent
සමගි	Reconciliation
සමතලා	Flat
සමත්	Managed
සමතුලිත	Balanced
සමථයකට	Settlement
සමනලයා	Butterfly
සමන්විත	With
සමබරතාව	Balance
සමමිතිකව	Symmetrically
සමරුව	Commemoration
සමස්ථ	Total
සමහරු	Some
සම්පත්	Resources
සම්ප්‍රදායික	Traditional
සම්ප්‍රේෂණය	Transmission
සම්පාදනය	Compilation
සම්පූර්ණ	Full
සම්බන්ධතා	Contacts
සම්බන්ධය	Relationship
සම්බන්ධව	About
සම්බන්ධීකරණය	Coordination
සම්බාධක	Sanctions
සම්භාව්‍ය	Classical
සම්භාවිතාවයන්	Probability
සම්මත	passed
සම්මන්ත්‍රණ	Conference
සම්මාන	Awards
සම්මුතිය	Convention
සම්මේලනය	Conference
සමාගම	company
සමාගම්	companies
සමාජය	Club
සමාජවාදී	Socialist
සමාජසේවා	Social Services
සමාජිකයන්	Members
සමාධිය	Concentration
සමාන	Similar
සමානකම්	Similarities
සමාන්තරව	Parallel
සමාන්‍ය	The average
සමානාත්මතාව	Equality
සමානුපාතික	proportional
සමාප්ති	Closing
සමාරම්භ	Inauguration
ශ්‍රේෂ්ඨ	Great
ශ්‍රේෂ්ඨාධිකරණය	Supreme Court
ශාකය	Plant
ශාඛාව	Branch
ශාපය	Curse
ශාරීරික	Physical
ශාලාව	Hall
ශාස්ත්‍රය	Arts
ශාස්ත්‍රාල	academic
ශාස්ත්‍රීය	Classical
ශික්ෂණය	Greatness
ශිඛරය	Peak
ශිල්ප	Crafts
ශිල්පීන්	Photographers
ශිල්පීය	Craft
ශිලාලිපි	The inscriptions
ශිෂ්ටාචාරය	Civilization
ශිෂ්ඨාචාරය	Civilization
ශිෂ්‍ය	Students
ශිෂ්‍යත්වය	Scholarships
ශිෂ්‍යයා	Student
ශීඝ්‍රගාමී	Express
ශීඝ්‍රයෙන්	Rapidly
ශීතකරණය	Freezer
ශීතල	Cold
ශීර්ෂය	Title
ශීල්පියා	Persuading those
ශීලාචාර	Decent
ශුද්ධ	Net
ශුන්‍ය	Zero
ශුභ	Good
ශුභවාදී	Optimistic
ශුභාරංචිය	good news
ශූරත්වය	Bravery
ශූරතාවය	Championship
ශූරයන්	Champions
ශේෂය	Balance
ශෛලමය	Stone
ශෛලිය	Style
ශෝක	Condolence
ශෝකාන්තය	The tragedy
ශෝචනීය	Tragically,
ශෝධනය	Refine
සංකලනය	remix
සංකල්පය	Concept
සංක්ෂිප්ත	Brief
සංක්‍රමණය	Migration
සංක්‍රමණික	Migration
සංකීර්ණ	complex
සංකීර්ණය	Complex
සංකේත	Symbols
සංඛ්‍යා	Statistics
සංඛ්‍යාතය	Frequency
සංඛ්‍යානය	Statistics
සංඛ්‍යාලේඛන	Statistics
සංඛ්‍යාව	the number
සංගම්	Union
සංග්‍රහය	Code
සංග්‍රාමය	Battle
සංගීතඥයන්	Musicians
සංගීතය	Music
සංචාරක	Tourism
සංචාරකයා	Traveler
සංචාරය	the journey
සංචිතය	Pool
සංඥා	Signal
සංතෘප්ත	Saturated
සංදර්ශනය	Show
සංදේශය	Memorandum
සංයමය	Restraint
සංයුක්ත	compact
සංයුතිය	Composition
සංයෝගය	Synthesis
සංරක්ෂණය	Conservation
සංරක්ෂිත	Archive
සංවත්සරය	Anniversary
සංවර්ධන	Development
සංවර්ධිත	Developed
සංවාදය	Conversation
සංවිධාන	organizations
සංවිධායක	Organizer
සංවෘත	Closed
සංවේගය	Sympathy
සංවේදි	Sensitive
සංශෝධනය	Amendment
සංසදය	Forum
සංසන්දනය	Comparison
සංස්කරණය	Edit
සංස්කෘතික	cultural
සංස්කෘතිය	culture
සංස්ථාව	Corporation
සංසාර	Samsara
සංසුන්ව	Calm
සක්‍රීය	Active
සගයා	Colleague
සඟරාව	Magazine
සජිවී	Live
සටන්ක්‍රම	Saṭanakarama
සටන්කාමීන්	Fighters
සටන්	Fight
සටහන	Note
සතර	Four
සත්ක්‍රියාව	Satakaraiyaāva
සත්කාරය	Hospitality
සත්තු	Creatures
සත්වයා	Creature
සත්‍ය	Real
සතා	Creature
සති	Weeks
සතිඅන්ත	Weekend
සතිය	the week
සතු	Owned
සතුට	Happiness
සතුටුදායක	Satisfactory
සතුන්	animals
සතුරා	Enemy
සතුරු	Hostile
සතුව	Possession
සතෙක්	Creature
සදහා	For
සද්දය	Sound
සදාකාලික	Eternal
සදාචාරය	Morality
සදාචාරාත්මක	Moral
සදාහරිත	Evergreen
සදුදා	Monday
සනසන	Comfort
සන්තාපය	Anguish
සන්තෝස	Happy
සන්දර්ශනය	Concerts
සන්දියේ	Teens
සන්ධ්‍යාවේ	Evening
සන්ධානය	Alliance
සන්ධිස්ථාන	HIGHLIGHTS
විහිදෙයි	Shines
වීදිය	Street
වීදුරු	Glass
වීරක්‍රියා	Othniel
වීරයා	Match
වීරවරයා	Weerawansa
වෘක්ෂය	Tree
වෘත්තය	Circle
වෘත්තාකාර	Pie
වෘත්තිකයන්	Professionals
වෘත්තීය	Trade
වෙඩික්කාරයා	Shooter
වෙඩිල්ල	Fired
වෙදකම	Medicine
වෙදැදුරාණෝ	Physician
වෙනස	Difference
වෙනස්	change
වෙනස්කම	Difference
වෙනස්වීම	Change
වෙන්වීම	Separation
වෙනුවෙන්	for
වෙර	Sought
වෙරළ	Beach
වෙල	Untouchable
වෙල්යාය	PADDY
වෙලාව	Time
වෙස්කම්	Changes will
වෙස්වලාගෙන	Undercover
වෙහෙස	Hard
වෙළඳපොළ	Market
වෙළඳසැල්	Shop
වෙළඳාම	Sales
වෙළෙන්දා	Dealer
වෙළෙඳ	Trade
වෙළෙඳපොළ	Exchange
වෙළෙඳසල	Shop
වෙළෙඳාම	Trade
වෙළෙඳුන්	Dealers
වේගය	Speed
වේතනය	Wage
වේදනාව	Pain
වේදිකාව	Platform
වේල්ල	Dam
වේලාව	Time
වෛද්‍යවරයා	Doctor
වෛද්‍යසේවා	Medical Services
වෛද්‍යාචාර්ය	physician
වෛරය	Hatred
වෛරස	Virus
ශක්තිය	strength
ශක්‍යතාවය	Potential
ශතවර්ෂය	Century
ශබ්දකෝෂය	Dictionary
ශබ්දය	Sound
ශරීරය	body
ශරීරික	Physical
ශල්‍යකර්මය	Surgery
ශ්වසනය	Breathing
ශ්වේත	White
ශ්‍රද්ධාව	Odds
ශ්‍රමය	Labor
ශ්‍රවණය	Hearing
ශ්‍රවනාගාරයේ	Auditorium
ශ්‍රව්‍ය	Audio
ශ්‍රව්‍යාබාධිත	deaf
ශ්‍රීලංකාව	From Sri Lanka
ශ්‍රේණිය	Grade
විද්වතා	Scholar
විද්ශිකයො	Tourists
විද්‍යාගාර	Laboratories
විද්‍යාඥයෝ	Scientists
විද්‍යාත්මක	Scientific
විද්‍යාලය	College
විද්‍යාලයීය	College
විද්‍යාලයේ	College
විද්‍යාව	Science
විද්‍යුත්	Electric
විදිනවා	Throws
විදිය	The Way
විදියට	As
විදීමට	Releases
විදුලිපන්දම	Torch
විදුලිය	Power
විදුහල්	Colleges
විදුහල්පති	the principal
විදුහල්පතිවරයා	Principal
විදුහලේ	College
විදේශ	foreign
විදේශාධාර	freign aid
විදේශිකයෝ	Foreigners
විදේශීය	foreign
විධාන	Command
විධායකය	Executive
විධායකවරුන්	Executives
විධි	Tricks
විධිමත්	Formal
විනය	Disciplinary
වින්දනය	Entertainment
විනාඩිය	Minute
විනාශකාරී	Disastrous
විනාශය	Destruction
විනාස	Destruction
විනිමය	Exchange
විනිවිද	Transparency
විනිසුරුවරයා	Judge
විනීත	Wear
විනෝදය	Entertainment
විනෝදාංශය	Hobby
විඳවන	Suffer
විපක්ෂය	Opposition
විපත	Woe
විපරම්	Follow
විප්ලවය	revolution
විපාක	Reward
විභාගය	Examination
විමතිය	Surprise
විමසිල්ලෙන්	Watch
විමසීම්	Contact
විමසීමෙන්	Consultation
විමුක්තිය	Liberation
වියදම	cost
වියන	Woven
වියපත්	Aging
වියරුව	Frenzy
වියලි	Dry
වියවුල්	Confusion
වියළි	Dry
වියෝව	Loss
විරසක	Alienation
විරාමය	Pause
විරැකියාව	Unemployment
විරුද්ධ	Against
විරුද්ධව	against
විරුද්ධවාදින්	Opponents
විරුද්ධවීම	Opposing
විරුවන්	Heroes
විරූපී	Asymmetrically
විරෝධතා	protests
විරෝධය	Protest
විරෝධියකු	NPT
විරෝධී	Anti
විල	Lake
විලාපය	Rattle
විලාසය	Style
විලාසිතා	Fashion
විලිසිතාව	Fashion
විවර	Opening
විවරණය	Review
විවරය	Aperture
විවරව	Develops
විවාදය	Debate
විවාහ	Married
විවාහක	Married
විවාහය	marriage
විවිධ	Different
විවිධත්වය	Diversity
විවිධසේවා	Multipurpose
විවිධාකාර	Different
විවෘත	open
විවෘතව	Open
විවේකය	Rest
විවේකාගාරය	Lounge
විවේකිව	Gallery
විවේචකයෝ	Critics
විවේචනය	Criticize
විශ්කම්භය	Diameter
විශ්මය	Wonders
විශ්ලේෂක	Analyst
විශ්ලේෂණය	Overview
විශ්වකෝෂයත්	Vaiśavakaeāṣayata
විශ්වය	Universe
විශ්වවිද්‍යාලය	University
විශ්වාසය	trust
විශ්වාසවන්ත	faithful
විශ්‍රාම	Pension
විශ්‍රාමික	Retired
විශාරද	Wizard
විශාල	large
විශිෂ්ට	Outstanding
විශිෂ්ටත්වය	Excellence
විශිෂ්ඨ	Excellent
විශේෂ	Special
විශේෂඥයා	Expert
විශේෂඥවරයා	Specialist
විශේෂත්වය	Specialty
විශේෂවේදී	Special
විශේෂාංගය	Feature
විශේෂිත	specific
විෂබීජ	Germs
විෂම	Hetero
විෂමතා	Anomalies
විෂමතාවය	Inequality
විෂයයන්	Subjects
විෂවීම	Overdose
විෂ්කම්භය	Diameter
විස	Toxic
විසන්ධි	Disconnect
විසඳීම	Solving
විසඳුණා	Answered
විසඳුම්	Solutions
විස්තරය	Description
විස්තරාත්මක	Detailed
විස්තාරය	Amplitude
විස්ථාපනය	Replacement
විස්මය	Amazing
විස්මිත	Amazing
විස්වාසය	Confidence
විස්සයි	twenty
විසැඳීම	Slove
විසැඳුම්	Solutions
විසිකල	Pick
විසිතුරු	Ornamental
විසින්	By
විසිනි	By
විසිපහ	Twenty five
විසිරී	Scattered
විසිවැනි	Twentieth
විසිවුණ	Semis
විසිවෙයි	Semis
විසිහතර	Twenty four
විසිහය	Twenty six
විසීම	Rooming
විසුරුවා	Dissolved
විහඟුන්	birds
විහාරස්ථානය	Temple
විහිදී	Spread
විහිදෙන	Spread
ඉදිමීම	bump
ඉදිරි	front
ඉදිරිකාලය	forward
ඉදිරිපත්	adducent
ඉදිරිපස	presence
ඉදිරිපිට	before
ඉදිවන	constructing
ඉදුණිල්	sapphire
ඉදුණු	mellow
ඉදුරා	definitely
ඉදෙන	riping
ඉනට	hip
ඉන්	thereby
ඉන්ජිනේරු	engineer
ඉන්ද්‍රියන්	organ
ඉන්දිය	indian
ඉන්ධන	fuel
ඉන්න	stick
ඉන්පස්සේ	thereafter
ඉන්පසු	thereafter
ඉනි	
ඉනික්බිති	afterward
ඉනිම	inning
ඉඳගන්නට	sitting
ඉඳිආප්ප	string hoppers
නිල්               blue
කොල           green
කහ              yellow
දම්               purple

ඉඳුනිල්	sapphire
ඉඳුරා	definitely
ඉපදිණි	born
ඉපනැල්ල	stubble
ඉපයීම	earning
ඉපැරණි	Age-old
ඉබ්බන්	tortoises
ඉබේ	automatically
ඉමහත්	extraordinary
ඉමිහිරි	honeyed
ඉර	Sun
ඉරණම	fate
ඉරනවද	rip
ඉරි	stripes
ඉරිගු	corn
ඉඟුරු	ginger
ඉරිතලා	cracking
ඉරිදා	Sunday
ඉරියව්	postural
ඉරීම	ripping
ඉරුණු	ripping
ඉලක්ක	target
ඉලක්කම්	numbers
ඉලන්දාරියා	youth
ඉල්ලති	applying
ඉල්ලම්	outcrop
ඉල්ලීම	applying
ඉල්ලුම්කරු	applicant
ඉල්ලුම්පත්	applications
ඉලෙක්ට්‍රොනික	electronic
ඉව	trail
ඉවත	away
ඉවර	finish
ඉවසන්න	patience
ඉවහල්	helpful
ඉවුම්	cuisine
ඉවුර	shore
ඉෂ්ට	desired
ඉස	
ඉසව්ව	direction
ඉස්කුරුප්පු	screw
ඉස්කෝල	school
ඉස්තරම්	best
ඉස්පාසුවක්	leisure
ඉස්පිරිතාලෙ	hospital
ඉස්මත්තෙන්	
ඉස්ලාමය	islam
ඉස්සන්	prawns
ඉස්සර	previously
ඉස්සරහ	front
ඉස්සීමක්	bearing
ඉස්සෙල්ල	first
ඉසිලීමට	bearing
ඉහත	above
ඉහල	above
ඊට	thereto
ඊටපසු	thereafter
ඊතල	arrows
ඊමේල්	email
ඊයක	arrow
ඊයම්	lead
ඊයෙ	yesterday
ඊයේ	yesterday
ඊර්ෂ්‍යා	jealouse
ඊර්ෂ්‍යාව	jealouse
ඊර්ෂ්‍යාවකින්	jealousy
ඊලඟ	next
ඊලඟට	next
ඊශාන	northeast
ඊශානදිග	northeast
ඊසාන	northeast
ඊළග	next
ඊළඟ	next
උකස	mortgage
උකහා	dragging
උක්ගස්	suger canes
උක්ත	mentioned
උකුණන්	lice
උකුල්	hips
උකුස්සකු	eagle
උකුළේ	hip
උගත	educated
උගන්වනවා	teaching
උගස්	mortgaging
උග්‍ර	critical
උගැන්ම	teaching
උගැන්මකින්	teaching
උගුර	throat
උගුල්	trap
උගෙ	its
උගේ	its
උච්ච	high
උච්චාරණය	pronounciationing
උච්චාවචනයද	fluctuating
උචිත	suitable
උජාරු	dashing
උට්ඨාන	rising
උඩ	up
උඩරට	upcountry
උඩවැඩියා	orchid
උඩින්	up
උඩුකය	bust
උඩුකුරු	orthotropic
උඩුබැලි	supine
උඩුමහල්වල	upstairs
උඩුයටිකුරු	orthotropic
උණ	fever
උණගස්	bamboo
උණ්ඩ	ammunition
උණු	warm
උණුකිරීම	fusion
උණුවතුර	hotwater
උණුසුම	heat
උත්කර්ෂවත්	dignified
උත්කෘෂ්ට	adorable
උත්තම	excellent
උත්තර	boreal
උත්තරීතර	super
උත්තරීතරම	super
උත්තල	convex
උත්තේජක	stimuli
උත්පත්ති	birth
උත්පාදක	generative
උත්පාදන	proceeds
උත්සන්න	elevated
උත්සව	ceremonial
උත්සහ	attempting
උත්සුක	anxious
උතුමන්	chief
උතුම්	best
උතුර	north
උතුරන	boiling
උතුරුමැද	boreal
උදම්	tidal
උදය	morning
උදර	belly
උදරය	stomach 
උදලු	hoes
උදව්	help
උදවිය	people
උදවු	help
උදහරණයක්	egsample
උදහස	anger
උදළු	hoes
උද්ගත	risen
අං	Horns
අංක	No.
අංකල්	Uncle
අංකුර	Shoots
අංකෙළිය	Aṁkaeḷaiya
අංග	Features
අංගචලන	Wear
අංගනය	Yard
අංගනයකට	Yard
අංගනයට	Park
අංගනයේ	Yard
අංගනයේදී	Yard
අංගනවලට	Compound
අංගපුලාවකට	Aṁgapaulaāvakaṭa
අංගම්මන	Aṁgamamana
අංගය	Feature
අංගයක්ද	Even part
අංගයකි	Component
අංගයන්ගෙන්	Features
අංගවල	ACTS
අංගවිකල	Handicapped
අංගුලිමාල	amgulimala
අංගුලිමාලගේ	amgulimala's
අංගොඩ	angoda
අංගෝපාංග	Features
අංගෝපාංගයන්	Features
අංගෝපාංගවලින්	Features
අංවලින්	Horns
අංශ	Divisions
අංශක	Degrees
අංශබාගය	Paralytic
අංශභාග	Paralyzed
අංශය	Section
අංශයකම	Sectors
අංශයක්	Section
අංශාධිපති	Head
අංශු	Particles
අංශුමාත්‍ර	Trace
අංශුව	Particle
අකටයුත්තක්	Irregularity
අකමැත්ත	Objections
අකරතැබ්බයක්	Scenario
අකර්මණ්‍ය	Passive
අකර්යක්ෂම	Ineffective
අකර්ශනීය	attractive
අකර්ෂණීය	attractive
අකලංක	Unblemished
අකල්	Untimely
අක්කා	elder sister
අක්කර	acres
අක්කරය	Acres
අක්බඹරු	Curly
අක්මාවේ	Liver
අක්මීමන	akmmemana
අක්ෂය	Axis
අක්ෂාංශය	Latitude
අක්ෂාංශවල	Latitudes
අක්ෂි	Eye
අක්‍රමවත්	Unusual
අක්‍රමිකතා	Irregularities
අක්‍රමිකතාව	Disorder
අක්‍රමිකතාවක්	Irregularity
අක්‍රිය	Inactive
අකාබනික	Inorganic
අකාරයට	Abyss
අකාරයටත්	Alphabetical
අකාර්යක්ෂම	Ineffective
අකාරුණික	Mistreatment
අකාලයේ	Untimely
අකැප	Kamini
අකැමැත්ත	Unwillingness
අකීකරු	Disobedience
අකුණක	Lightning
අකුර	letter
අකුරු	letters
අකුල	bill
අකුල්	Mosaic
අකුලා	Withdrawn
අකුසල	Effaced
අකුළන	Scroll
අකුළා	rolled
අඛණ්ඩ	Continuous
අඛණ්ඩතාවය	Continuity
අඛණ්ඩව	Continue
අග	End
අගට	End
අගත්	End
අගති	Unprejudiced
අගතිගාමිවන	Unprejudiced
අගතිගාමී	Biased
අගතිය	Prejudice
අගතියක්	Prejudice
අගතියට	Prejudice
අගතියෙන්	Prejudice
අගදී	End
අගනගරය	Capital
අගන්‍යාශ	pancreas
අගන්‍යාශයේ	pancreas
අගනා	Excellent
අගනුවර	capital
අගනේ	Worth
අගපසඟ	features
අගභාගයේ	LATE
අගමැති	Prime Minister
අගමුල්	Anatomy
අගය	value
අගයන්නේ	Appreciate
අගයෙන්	value
අගරජ	Emperor
අගරජු	Emperor
අගරදගුරු	Archbishop
අගරු	Dishonored
අගලක	Moat
අගලකට	Moat
අගලේ	Moat
අගවන	Svalbard
අගවමින්	Heavily
අගවිනිසුරු	Justice
අගහරුවාදාය	Tuesday
අගහිගකම්වලින්	poverty
අගහිඟකම්	Needy
අග්ගලා	Sage
අග්නි	fire
අග්නිදිග	Southeast
අග්‍ර	Chief
අග්‍රගණ්‍ය	Distinguished
අග්‍රය	Terminal
අග්‍රයේ	Console
අග්‍රවිනිශ්චයකාර	Justice
අග්‍රාණ්ඩුකාරවරයා	Represented
අග්‍රාමාත්‍ය	Prime
අගාධයකට	Abyss
අගාධයට	Abyss
අගාධයෙන්	Abyss
අගැයීමකට	Appraisal
අගැයීමක්	Appraisal
අගැයීමට	Revaluation
අගැයුම්	Evaluation
අගුලට	lock
අගුල්	lock
අගුලු	lock
අගුවක	lock
අගුළු	lock
අගේ	groovy
අගේට	groovy
අගොස්තුවේදී	August
අගෝස්තු	August
අගෝස්තුවේ	August
අගෝස්තුවේදී	August
අගෞරවයක්	discourtesy
අඟ	horn
අඟක්	horn
අඟනෝ	ladies
අඟපසඟ	features
අඟලක්	inch
අඟල්	inches
අඟලෙන්	inch
අඟවති	hint
අඟහරු	mars
අඟහරුගේ	mars
අඟහරුවා	mars
අඟහරුවාදාට	Tuesday
අඟහරුවාදාය	Tuesday
අඟහිඟ	poverty
අඟුරු	carbon
අඟුරුබවට	carbon
අඟුලට	boat
අඟුළු	bolt
අඟුළුවා	Anguluwa
අචල	constant
අචලව	constant
අච්චාරු	pickle
අච්චාරුවකට	pickle
අච්චු	dies
අච්චුද	dies
අචාර්ය	teacher
අචීචිමහ	inferno
අජීර්ණ	indigestion
අජීව	dead
අජීවි	dead
අජේ	ajey
අඥාත	anonymous
අඥාන	foolish
අට	eight
අටපට්ටම්	octagonal
අටපිරිකර	requisites
අටමස	eight months
අටමස්ථාන	Atamasthanaya
අටමස්ථානයට	Atamasthanaya
අටයි	eight
අටරියන්	eight cubits
අටලක්ෂයකට	eight lakh
අටවන	eighth
අටවැනි	eighth
අටසිය	eight hundrad
අටසියකට	eight hundrad
අටසිල්	eight precepts
අටසීයක්	eight hundrad
අටහමාරට	half past eight
අටහැවිරිදි	eight
අටළොස්	eighteen
අට්ටාල	stage
අටියෙන්	desire
අටියෙනි	desire
අටු	barn
අටුකොටු	barn
අටුකොටුව	barn
අටුකොටුවද	barn
අටුව	barn
අටුවා	commentary
අටුවාව	commentary
අටුවාවක්	commentary
අටුවේ	barn
අටෙන්	eighth
අටේ	eight
අඩ	half
අඩංගු	contained
අඩක	half
අඩන්තේට්ටම්	assault
අඩපණ	exhausted
අඩම්තේට්ටම්වලට	assault
අඩමාන	precarious
අඩවන්	half
අඩවිය	forest
අඩස්සියකට	imprisonment
අඩසිය	half century
අඩසියවසක	half century
අඩාල	dimidiate
අඩි	feet
අඩිකෝදු	footrule
අඩිතාලම	foundation
අඩිපාර	foot path
අඩිය	foot
අඩු	less
අඩුකම	less
අඩුකමයි	inferiority
අඩුකර	diminish
අඩුක්කර	pack
අඩුකැර	subdued
අඩුකිරීමට	decrease
අඩුගානේ	at least
අඩුතරමින්	at least
අඩුපහඩු	defects
අඩුබර	underweight
අඩුම	less
අඩුමකුඩුම	stuff
අඩුමිලකට	upset price
අඩුමිලට	upset price
අඩුය	is less than
අඩුයි	is less than
අඩුලුහුඬුකම්ය	shortcomings
අඩුලුහුඬුතාව	shortcomings
අඩුව	shortcomings
අඩුවකට	shortcomings
අඩුවක්	shortcomings
අඩුවක්ද	shortcomings
අඩුවකි	shortcomings
අඩුවට	shortage
අඩුවන	decreasing
අඩුවනතුරු	decreasing
අඩුවන්නට	decreasing
අඩුවනු	decreasing
අඩුවැඩිය	implements
අඩුවැඩියක්	implements
අඩුවිමත්	reduced
අඩුවිය	reduced
අඩුවියදමකින්	cheap
අඩුවී	reduced
අඩුවීම	reduced
අණ	command
අණකරුගේ	drawers
අණක්	command
අණදීමේ	command
අණදෙන	command
අණදෙමින්	command
අණපණත්වල	precept
අණපනත්	precept
අණපනත්වලින්	precept
අණසක	precept
අණසකට	precept
අණ්වික්ෂයක්	microscope
අණ්වීක්ෂය	microscope
අණ්වීක්ෂයේ	microscope
අණාවරණය	detection
අණින්	command
අණු	atomic
අණුක	molecular
අණුකූල	apropos
අණුකූලව	apropos
අණුව	apropos
අණුවක	molecule
අණුවක්	molecule
අණුවකින්	molecule
අණුවල	molecules
අඬ	noise
අඬගැසීමට	call
අඬති	cry
අඬදබර	quarrels
අඬදබරවලට	quarrels
අඬනව	cry
අඬන්න	cry
අඬන්නට	cry
අඬහැරයයි	chevy
අඬා	cry
අඬාපු	cry
අත	hand
අතක	hand
අතකට	hand
අතක්	hand
අතකින්	hand
අතකුත්	hand
අතකොලුවක්	wooden mallet
අතගත්	wedded
අතගසන	assist
අතගසා	assist
අතගා	assist
අතගාති	massage
අතගානා	massage
අතගාමින්	massage
අතගැසීමේ	massage
අතගෑව	massage
අතට	hand
අතටපත්වීම	handed
අතටය	hand
අතදී	reach
අතදීමක්ද	reach
අතදෙන	reach
අතන	there
අතනින්	there
අතපත	touch
අතපත්තු	atapattu
අතපත්තුගේ	atapattu
අතපත්තුට	atapattu
අතපත්තුත්	atapattu
අතපය	eagled
අතපයත්	eagled
අතපසු	dilatory
අතපසුවීමකින්	dilatory
අතපාන්න	beg
අතපාන්නට	beg
අතපෙවීම	interfere
අතමයි	hand
අතමිට	means
අතර	between
අතරට	interject
අතරත්	between
අතරතුර	between
අතරතුරදී	between
අතරතුරේ	between
අතරතුරේදිය	between
අතරතුරේදී	between
අතරද	between
අතරදී	between
අතරදීත්	between
අතරදීම	between
අතරම	between
අතරමං	lost
අතරමංව	lost
අතරමංවන	lost
අතරමංවීම	lost
අතරමංවූ	lost
අතරමංවෙලා	lost
අතරමග	in transit
අතරමගකදී	in transit
අතරමගදි	in transit
අතරමගදී	in transit
අතරමගදීය	in transit
අතරමඟ	in transit
අතරමඟදී	in transit
අතරමඟදීම	in transit
අතරමැද	in transit
අතරමැදි	in transit
අතරමැදියන්	intermediary
අතරමැදියා	intermediary
අතරමැදියෙකු	intermediary
අතරමැදිව	intermediary
අතරය	among
අතරයි	among
අතරවාරයේ	ad interim
අතරවාරයේදීයි	ad interim
අතරවාරේ	ad interim
අතරින්	among
අතරින්ද	among
අතරිනුත්	among
අතරෙ	among
අතරෙදි	among
අතරෙදී	among
අතරෙන්	among
අතරෙනුත්	among
අතරෙහි	among
අතරේ	among
අතරේන්	among
අතලොස්ස	handful
අතලොස්සක	handful
අතලොස්සක්	handful
අතලොස්සක්ද	handful
අතවනා	call
අතවර	abuse
අතවරය	abuse
අතවරයකි	abuse
අතවරයට	abuse
අතවරයනට	abuse
අතවරයන්ට	abuse
අතවරවලට	abuse
අතවශ්‍ය	essential
අතවැසියකු	servant
අතවැසියන්ට	servant
අතශයින්	extremely
අතහැර	omission
අතහිත	help
අතළඟ	nearby
අතළඟටම	nearby
අතළඟද	nearby
අතළොස්සකට	handful
අතළොස්සක්	handful
අතළොස්සකි	handful
අතළොස්සෙන්	handful
අත්	hands
අත්අකුරින්	hand writing
අත්අඩංගුව	clutches
අත්අඩංගුවකට	take into custody
අත්අඩංගුවට	take into custody
අත්අඩංගුවේ	take into custody
අත්අඩංගුවේදී	take into custody
අත්ඇරුණම	miss
අත්ඇරුණාම	miss
අත්කමට	handicraft
අත්කම්	handicraft
අත්ට්‍රැක්ටරයක්	tractor
අත්ත	branch
අත්තක	branch
අත්තක්	branch
අත්තට	branch
අත්තටු	wings
අත්තනගල්ල	aththanagalla
අත්තනගල්ලේ	aththanagalla
අත්තනායක	aththanayaka
අත්තම්මා	grand mother
අත්තම්මෙ	grand mother
අත්තිකාරමක්	advance
අත්තිකාරම්	advance
අත්තිඩිය	aththidiya
අත්තිවාරම	foundation
අත්තිවාරමක්	foundation
අත්තිවාරම්	foundation
අත්තිවාරම්ද	foundation
අත්තෙන්	branch
අත්තේ	branch
අත්දකින	experience
අත්දකින්න	experience
අත්දකින්නට	experience
අත්දකීම්	experience
අත්දැකීම	experience
අත්දැකීමකට	experience
අත්දැකීමක්	experience
අත්දැකීමක්ද	experience
අත්දැකීමකි	experience
අත්දැකීම්	experience
අත්දැකීම්ය	experience
අත්දැකීම්වල	experience
අත්දැකීම්වලින්	experience
අත්දැකීමෙන්	experience
අත්දැකීමේ	experience
අත්දුටු	experience
අත්දුටුවෙමු	experience
අත්දෙක	hands
අත්නොහරින	retention
අත්නොහළහ	retention
අත්නොහැරියේය	retention
අත්පන්දු	volley ball
අත්පොලසන්	applause
අත්පොළසන්	applause
අත්බෑග	hand bag
අත්බෑග්	hand bag
අත්බෝම්බ	granade
අත්බෝම්බයක්	granade
අත්මිදෙන්නට	prevent
අත්වැරදි	errors 
අත්වැරැද්දක්	errors 
අත්වැරැදීම	errors 
අත්වැරැදීමකින්	errors 
අත්වැල	aid
අත්වැලක්	aid
අත්වැලකින්	aid
අත්වැලට	aid
අත්වැල්	aid
අත්වැසුම්	glove
අත්සන	signature
අත්සන්	signature
අත්සන්තබන	signature
අත්සනින්	signature
අත්හදා	experiment
අත්හදාබැලීම්	experiment
අත්හර	omit
අත්හරවන්න	omit
අත්හරින	omit
අත්හරින්නේ	omit
අත්හරිනු	omit
අත්හරී	omit
අත්හල	omit
අත්හලේ	omit
අත්හළ	omit
අත්හැර	omit
අත්හැරදමා	omit
අත්හැරවීමේ	omit
අත්හැරීම	omit
අත්හැරීමට	omit
අත්හැරීමෙන්	omit
අත්හැරීමේ	omit
අත්හැරුණම	omit
අත්හිටුවන	suspend
අත්හිටුවන්නැයි	suspend
අත්හිටුවා	suspend
අත්හිටුවි	suspend
අත්හිටුවිය	suspend
අත්හිටුවී	suspend
අත්හිටුවීම	suspend
අත්හිටුවීමට	suspend
අත්හිටුවීමෙන්	suspend
අත්‍යවශ්‍ය	essential
අත්‍යවශ්‍යතම	essential
අත්‍යවශ්‍යතා	essential
අත්‍යවශ්‍යමයි	essential
අත්‍යවශ්‍යය	essential
අත්‍යවශ්‍යයයි	essential
අත්‍යවශ්‍යයි	essential
අත්‍යවශ්‍යයෙන්ම	essential
අත්‍යාතතිය	essential
අත්‍යාවශය	essential
අත්‍යාවශ්‍ය	essential
අතැඟිලි	fingers
අතිරේක	additional
අතිරේකය	additional
අතිරේකව	additional
අතිවිශාල	huge
අතිවිශාලය	huge
අතිවූ	huge
අතිශය	huge
අතිශයින්	huge
අතිශයින්ම	huge
අතිශයෙන්	huge
අතිශයෝක්තියක්	exaggeration
අතිශයෝක්තියට	exaggeration
අතිශයෝක්තියෙන්	exaggeration
අතීත	past
අතීතය	past
අතීතයක	past
අතීතයකට	past
අතීතයක්	past
අතීතයට	past
අතීතයෙන්	past
අතීතයෙහි	past
අතීතයේ	past
අතීතයේදී	past
අතීතයේම	past
අතුගා	sweep
අතුගෑවී	sweep
අතුගෑවෙන	sweep
අතුරුදන්	disappear
අතුරුදන්ව	disappear
අතුරුදන්වීම	disappear
අතුරුදහන්	disappear
අතුරුදහන්ව	disappear
අතුරුපස	dessert
අද	Today
අදක්ෂ	clumsy
අදටත්	Today
අදත්	Today
අදද	Today
අදපටන්	Today
අදම	Today
අදමේ	Today
අදයි	Today
අදහන	believing
අදහන්න	believing
අදහන්නන්	believing
අදහන්නේ	believing
අදහපු	believing
අදහස	idea
අදහසක්	idea
අදහසකි	idea
අදහසකින්	idea
අදහසකිනි	idea
අදහසට	idea
අදහසත්	idea
අදහසද	idea
අදහසම	idea
අදහසය	idea
අදහසයි	idea
අදහස්	idea
අදහස්කොට	idea
අදහස්ය	idea
අදහස්වන්නේ	idea
අදහස්වල	idea
අදහස්වලට	idea
අදහස්වලින්	idea
අදහසින්	idea
අදහසිනි	idea
අදහසුත්	idea
අදහසෙකි	idea
අදහසෙන්	idea
අදහසෙහි	idea
අදහසේ	idea
අදහා	believing
අදහාගත	believing
අදහාගන්න	believing
අදියර	chapter
අදියරකට	chapter
අදියරක්	chapter
අදියරට	chapter
අදියරයි	chapter
අදියරෙන්	chapter
අදියරේ	chapter
අදියරේදී	chapter
අදුරු	dark
අදුරේ	dark
අධ්‍යක්ෂ	director
අධ්‍යක්ෂක	director
අධ්‍යක්ෂණය	director
අධ්‍යක්ෂණයේදී	director
අධ්‍යක්ෂතුමා	director
අධ්‍යක්ෂවරයකු	director
අධ්‍යක්ෂවරයා	director
අධ්‍යක්ෂවරයාට	director
අධ්‍යක්ෂවරයෙකි	director
අධ්‍යක්ෂවරයෙකු	director
අධ්‍යක්ෂවරිය	director
අධ්‍යක්ෂවරු	director
අධ්‍යක්ෂවරුන්	director
අධ්‍යක්ෂවරුන්ගෙන්	director
අධ්‍යක්ෂිකා	director
අධ්‍යක්ෂිකාව	director
අධ්‍යක්ෂිකාවක	director
අධ්‍යක්ෂිකාවක්	director
අධ්‍යනය	study
අධ්‍යනයක්	study
අධ්‍යනයකින්	study
අධ්‍යනයට	study
අධ්‍යනයනය	study
අධ්‍යනයන්ට	study
අධ්‍යපනය	study
අධ්‍යපනයට	study
අධ්‍යයන	study
අධ්‍යයනය	study
අධ්‍යයනයක	study
අධ්‍යයනයකට	study
අධ්‍යයනයකදී	study
අධ්‍යයනයක්	study
අධ්‍යයනයකින්	study
අධ්‍යයනයට	study
අධ්‍යයනයන්	study
අධ්‍යයනයන්ගෙන්	study
අධ්‍යයනයන්ට	study
අධ්‍යයනයෙන්	study
අධ්‍යයනයෙහි	study
අධ්‍යයනයේදී	study
අධ්‍යයනවලට	study
අධ්‍යයනවලින්	study
අධ්‍යාපන	education
අධි	high
අධිකතර	high
අධිකම	high
අධිකය	high
අධිකරණ	law courts
අධිකරණමය	law courts
අධිකරණය	law courts
අධිකරණයක	law courts
අධිකරණයකට	law courts
අධිකරණයක්	law courts
අධිකරණයකින්	law courts
අධිකරණයට	law courts
අධිකරණයටත්	law courts
අධිකරණයන්ට	law courts
අධිකරණයෙන්	law courts
අධිකරණයෙන්ම	law courts
අධිකරණයෙනුත්	law courts
අධිකරණයේ	law courts
අධිකරණයේදී	law courts
අධිකරණවල	law courts
අධිකරණවලට	law courts
අධිතාක්ෂණය	high tech
අධිතාක්ෂණයෙන්	high tech
අධිතාක්ෂණික	high tech
අධිපති	chief
අධිපතිත්වය	chief
අධිපතිතුමා	chief
අධිපතියකු	chief
අධිපතියා	chief
අධිවේගී	Express
අධිශීතකරණ	super cooled
අධිෂ්ඨාන	determination
අධෛර්ය	discouragement
අධෛර්යමත්	discouragement
අධෛර්යයට	discouragement
අධෛර්යවත්ව	discouragement
අනගි	worth
අනතුර	accident
අනතුරක	accident
අනවශ්‍ය	unnecessary
අනවසරයෙන්	unnecessary
අනවසරයෙනි	unauthorized
අන්තර්ජාතික	international
අන්තර්ජාතිකව	international
අන්තර්ජාල	internet
අන්තර්ජාලය	internet
අන්තර්ජාලයට	internet
අන්තර්ජාලයෙන්	internet
අන්තිම	last
අන්තිමට	last
අන්තිමයි	last
අන්තිමේ	last
අන්තිමේදී	last
අන්ධ	blind
අන්ධකාරයට	dark
අන්ධකාරයෙ	dark
අන්ධකාරයෙන්	dark
අන්නාසි	pineapple
අනාගත	future
අනාගතය	future
අනාගතයක්	future
අනාගතයට	future
අනාගතයේ	future
අනාගතයේදි	future
අනාගතයේදී	future
අනාථ	orphan
අනාථකඳවුරු	orphanage
අනාථයන්	orphans
අනාථයි	orphans
අනාථවූවන්ට	orphans
අනාථාගරයකදී	orphans
අනාථාගාරය	orphans
අනාථාගාරයට	orphans
අනාථාගාරයෙන්	orphans
අනාථාගාරයේ	orphans
අනාරක්ෂිත	unprotected
අනුගමනය	imitation
අනුග්‍රහ	sponser
අනුමත	approved
අනුමතයි	approved
අඳුර	dark
අඳුරක්	dark
අපද්‍රව්‍ය	waste
අපද්‍රව්‍යයත්	waste
අපද්‍රව්‍යවල	waste
අපද්‍රව්‍යවලින්	waste
අපනයන	exports
අපනයනකරු	exports
අපනයනකරුට	exports
අපනයනකරුවකු	exports
අපනයනය	exports
අපනයනයකර	exports
අපනයනයට	exports
අපනයනයන්	exports
අපනයනයෙන්	exports
අපනයනයෙහි	exports
අපරදිග	western
අපරදිගින්	western
අපරාධ	crimes
අපරාධකරු	criminal
අපරාධකරුගේ	criminal
අපරාධකරුන්	criminal
අපරාධකරුවකු	criminal
අපරාධකරුවන්	criminal
අපරාධකරුවන්ගෙන්	criminal
අපරාධකරුවන්ට	criminal
අපරාධකාරයකුට	criminal
අපරාධකාරයන්	criminal
අපරාධකාරයෝ	criminal
අපරාධකාරී	criminal
අපරාධත්	criminal
අපරාධය	criminal
අපරාධයක	criminal
අපරාධයකට	criminal
අපරාධයක්	criminal
අපරාධයක්ද	criminal
අපරාධයකි	criminal
අපරාධයට	criminal
අපරාධයෙකි	criminal
අපරාධවල	criminal
අපරාධවලට	criminal
අපරාධවලටත්	criminal
අපරාධවලින්	criminal
අපහසු	difficult
අපහසුකම්	difficult
අපහසුතා	difficult
අපහසුතාව	difficult
අපහසුතාවකට	difficult
අපහසුතාවකටම	difficult
අපහසුතාවකින්	difficult
අපහසුතාවට	difficult
අපහසුතාවන්	difficult
අපහසුතාවන්ට	difficult
අපහසුතාවය	difficult
අපහසුතාවයකට	difficult
අපහසුතාවයක්	difficult
අපහසුතාවයකින්	difficult
අපහසුතාවයට	difficult
අපහසුතාවයන්	difficult
අපහසුතාවයන්ට	difficult
අපහසුතාවයයි	difficult
අපහසුතාවලට	difficult
අපහසුතාවලින්	difficult
අපහසුතාවෙන්	difficult
අපහසුනම්	difficult
අපහසුම	difficult
අපහසුය	difficult
අපහසුයි	difficult
අපහසුව	difficult
අපහසුවක්	difficult
අපහසුවකින්	difficult
අපහසුවට	difficult
අපහසුවයි	difficult
අපහසුවීම	difficult
අපහසුවීමත්	difficult
අපහසුවෙන්	difficult
අපහසුවේ	difficult
අප්‍රියෙල්	April
අප්‍රෙල්	April
අප්‍රේල්	April
අපිට	we
අපිටත්	we
අපිටවත්	we
අපිත්	we
අපිද	we
අපිදු	we
අපිම	we
අපිමයි	we
අපිරිසිදු	dirty
අපිරිසිදුකමත්	dirty
අපිරිසිදුම	dirty
අපිරිසිදුය	dirty
අපිරිසුදු	dirty
අපිරිසුදුතාව	dirty
අපිරිසුදුය	dirty
අපුරු	curious
අපුරුව	curious
අපේකෂිතය	expect
අපේක්ෂ	expect
අපේක්ෂක	candidate
අපේක්ෂකගේ	candidate
අපේක්ෂකත්වයෙන්	candidate
අපේක්ෂකයකු	candidate
අපේක්ෂකයනට	candidate
අපේක්ෂකයන්	candidate
අපේක්ෂකයන්ගේ	candidate
අපේක්ෂකයන්ට	candidate
අපේක්ෂකයනුත්	candidate
අපේක්ෂකයා	candidate
අපේක්ෂකයාගේ	candidate
අපේක්ෂකයාට	candidate
අපේක්ෂකයින්	candidate
අපේක්ෂකයින්ගේ	candidate
අපේක්ෂකයින්ට	candidate
අපේක්ෂකයෙක්	candidate
අපේක්ෂකයෝ	candidate
අපේක්ෂයන්	candidate
අපේක්ෂා	candidate
අපේක්ෂාකරන	candidate
අබ	mustard
අභ්‍යාස	excersice
අභ්‍යාසය	excersice
අභ්‍යාසයක	excersice
අභ්‍යාසයක්	excersice
අභ්‍යාසයකි	excersice
අභ්‍යාසයට	excersice
අභ්‍යාසයත්	excersice
අභ්‍යාසයන්	excersice
අභ්‍යාසයන්ගේ	excersice
අභ්‍යාසයෙන්ද	excersice
අභ්‍යාසයෙහි	excersice
අභ්‍යාසයේ	excersice
අභ්‍යාසලාබී	excersice
අභ්‍යාසලාභි	excersice
අභ්‍යාසලාභීන්	excersice
අභ්‍යාසවල	excersice
අභාග්‍ය	unlucky
අභාග්‍යමත්	unlucky
අභාග්‍යය	unlucky
අභාග්‍යයකට	unlucky
අභාග්‍යයක්	unlucky
අභාග්‍යසම්පන්න	unlucky
අභාවප්‍රාප්ත	late
අභාවප්‍රාප්තවේ	late
අභාවය	late
අභාවයට	late
අභාවයත්	late
අභාවයෙන්	late
අභියේගතා	challenge
අභියෝග	challenge
අභියෝගකාරි	challenge
අභියෝගකාරී	challenge
අභියෝගතා	challenge
අභියෝගය	challenge
අභියෝගයකට	challenge
අභියෝගයකටම	challenge
අභියෝගයක්	challenge
අභියෝගයක්ව	challenge
අභියෝගයකි	challenge
අභියෝගයට	challenge
අභියෝගයනට	challenge
අභියෝගයන්	challenge
අභියෝගයන්ට	challenge
අභියෝගයන්ටත්	challenge
අභියෝගයයි	challenge
අභියෝගවලට	challenge
අභියෝගාත්මක	challenge
අභිරහස	detective
අභිරහස්	detective
අභිරහස්වලින්	detective
අම්ම	mother
අම්මගෙ	mother
අම්මගේ	mother
අම්මට	mother
අම්මටත්	mother
අම්මටයි	mother
අම්මන්	mother
අම්මප	mother
අම්මයා	mother
අම්මයි	mother
අම්මල	mother
අම්මලගෙ	mothers
අම්මලා	mothers
අම්මලාගේ	mother
අම්මලාට	mother
අම්මාගෙනි	mother
අම්මාගේ	mother
අම්මාට	mother
අම්මාටත්	mother
අම්මාත්	mother
අම්මාද	mother
අම්මාන්	mother
අම්මාන්ගේ	mother
අම්මාන්ට	mother
අම්මාය	mother
අම්මාල්	mother
අම්මාල්ට	mother
අම්මාවරු	mothers
අම්මාවරුන්	mothers
අම්මාවරුන්ගේ	mothers
අම්මාවරුන්ට	mothers
අම්මාවරුනේ`	mothers
අම්මෙ	mother
අම්මේ	mother
අමාත්‍ය	minister
අමාත්‍යංශ	ministry
අමාත්‍යංශය	ministry
අමාත්‍යංශයක්	ministry
අමාත්‍යංශයට	ministry
අමාත්‍යංශයෙන්ද	ministry
අමාත්‍යංශයේ	ministry
අමාත්‍යංශයේත්	ministry
අමාත්‍යංශවල	ministry
අමාත්‍යතුමා	minister
අමුත්තක්	guest
අමුත්තකු	guest
අමුත්තන්	guest
අමුත්තන්ගේ	guest
අමුත්තන්ට	guest
අමුත්තා	guest
අමුත්තාට	guest
අමුත්තෙක්	guest
අමුත්තෙකු	guest
අමුත්තෝ	guest
අඹ	mango
අයිති	own
අයිතිකර	own
අයිතිකරු	own
අයිතිකරුගේ	own
අයිතිකරුට	own
අයිතිකරුවකු	own
අයිතිකරුවන්	own
අයිය	elder brother
අයියට	elder brother
අයියයි	elder brother
අයියලා	elder brother
අයියලාගේත්	elder brother
අයියලාට	elder brother
අයියා	elder brother
අයියාගේ	elder brother
අයියාට	elder brother
අයියාත්	elder brother
අයියාව	elder brother
අයියෙ	elder brother
අයියේ	elder brother
අර්ථය	meaning
අර්ථයක්	meaning
අර්ථයකින්	meaning
අර්ථයට	meaning
අර්ථයත්	meaning
අර්ථයෙන්	meaning
අර්ථයේ	meaning
අර්ථලාභය	meaning
අර්ථවත්	meaning
අලංකාර	beautiful
අලංකාරකොට	beautiful
අලංකාරම	beautiful
අලංකාරය	beautiful
අලංකාරයක්	beautiful
අලංකාරයට	beautiful
අලංකාරයත්	beautiful
අලංකාරයි	beautiful
අලංකාරයෙන්	beautiful
අලංකාරව	beautiful
අලංකාරවත්	beautiful
අලියකු	elephant
අලියකුගේ	elephant
අලියකුට	elephant
අලියට	elephant
අලියා	elephant
අලියාගේ	elephant
අලියාගේත්	elephant
අලියාට	elephant
අලියෙක්	elephant
අලියෙකු	elephant
අලියෙකුගෙ	elephant
අලිවලිගවල	elephant
අලිහසාන්	elephant
අලීන්	elephant
අලු	ash
අලුත්	new
අලෙවිකරණ	marketing
අලෙවිකරණය	marketing
අලෙවිකරණයේ	marketing
අලෙවිකරන්නන්	marketing
අලෙවිකරුවන්ට	marketing
අලෙවිය	marketing
අලෙවියක්	marketing
අලෙවියට	marketing
අලෙවියෙන්	marketing
අලෙවියේ	marketing
අලෙවිසල	marketing
අලෙවිසල්	marketing
අලෙවිසල්වලින්	marketing
අලෙවිහල්	marketing
අවංක	honest
අවංකකම	honest
අවංකකමට	honest
අවංකකමත්	honest
අවංකත්වය	honest
අවංකභාවයෙන්	honest
අවංකයි	honest
අවංකව	honest
අවංකවම	honest
අවුරුද්ද	year
අවුරුදු	years
අවුල	confusion
අවුලක	confusion
අවුලකට	confusion
අවුලක්	confusion
අවුලට	confusion
අශ්ව	horse
අශ්වයකු	horse
අශ්වයන්	horse
අශ්වයා	horse
අශ්වයාත්	horse
අශ්වයිනට	horse
අශ්වයින්	horse
අශ්වයෙක්	horse
අශ්වයෝ	horse
අස්වන්නට	harvest
අස්වන්නැයි	harvest
අස්වනු	harvest
පාට              colour
පාටයි           colour
අහසක්	sky
අහසට	sky
අහසත්	sky
අහස්	sky
අහසින්	sky
අහිංසක	innocent
අහිංසකකමට	innocent
අහිංසකම	innocent
අහිංසකයකු	innocent
අහිංසකයන්	innocent
අහිංසකයන්ය	innocent
අහිංසකයා	innocent
අහිංසකයාගේ	innocent
අහිංසකයාට	innocent
අහිංසකයි	innocent
අහිංසකයෝ	innocent
අළුත්	new
ආච්චි	grand mother
ආච්චිගෙ	grand mother
ආච්චිගෙන්	grand mother
ආච්චියෙක්	grand mother
ආච්චිලා	grand mother
ආච්චිලාටත්	grand mother
ආච්චී	grand mother
ආඩම්බර	proud
ආඩම්බරකාර	proud
ආඩම්බරය	proud
ආඩම්බරයක්	proud
ආඩම්බරයකි	proud
ආඩම්බරයට	proud
ආඩම්බරයෙන්	proud
ආඩම්බරයෙනි	proud
ආඩම්බරෙන්	proud
ආණ්ඩුව	government
ආදරය	love
ආදරවන්තයන්	lover
ආදරවන්තයන්ගේ	lover
ආදරවන්තයන්ට	lover
ආදරවන්තයාව	lover
ආදරවන්තියන්ට	lover
ආදායම	income
ආදායමක්	income
ආදායමකි	income
ආදායමකුත්	income
ආදායමට	income
ආදායමත්	income
ආදායමයි	income
ආදායම්	income
ආයතනයය	company
ආරක්ෂක	security
ආරක්ෂිත	secure
ආරම්භ	inaugural
ආරෝග්‍යශාලා	hospital
ආරෝග්‍යශාලායීය	hospital
ආරෝග්‍යශාලාවලින්	hospital
ආලෝක	light
ආලෝකරණය	lighting
ආසනවල	seat
ආසනවලින්	seat
ආසනවලින්	seat
ආසන්න	near
ආසයි	desire
ආස්වාද	enjoying
ආසාදන	infection
ආසියා	asia
ආසියාතික	asian
ආහාරයකි	foods
ආහාරවේල	meal
ඇගයීම	evaluation
ඇගිලි	fingers
ඇඟ	body
ඇඟලුම්	garments
ඇඟවීම	implication
ඇඟැලුම්	attachment
ඇඟිල්ල	fingers
ඇට	seeds
ඇටකටු	bones
ඇටමිඳුළු	marrow
ඇටසැකිල්ල	skeleton
ඇටිකුකුලා	crow pheasant
ඇණ	nail
ඇණවුම්	order
ඇණහිටිනු	failure
ඇඬුවා	cry
ඇත	have
ඇතමුන්	somebody
ඇත්	elephant
ඇත්ගොව්වා	mahout
ඇත්ත	TRUE
ඇත්දළ	ivory
ඇතැම්විට	sometimes
ඇතිල්ලීම	rub
ඇතිලි	pan
ඇතිවුණා	happen
ඇතුලට	inside
ඇතුල්වුණා	enter
ඇද	curved
ඇදවැටී	collapse
ඇදහිල්ල	belief
ඇදුම	asthma
ඇදුරකු	teacher
ඇනකොටාගන්න	fight
ඇනවුම	order
ඇනහිට	conk out
ඇන්ජින්	engine
ඇඳ	bed
ඇඳිරි	darkness
ඇඳිරිනීතිය	curfew
ඇඳුම	dress
ඇප	bond
ඇපකරු	guarantor
ඇබ්බැහි	habitual
ඇබෑර්තු	vacancy
ඇමති	minister
ඇමතුම	call
ඇමිණිය	meshed
ඇමුණුවා	clip
ඇඹරී	crushing
ඇඹුල්	sour
ඇය	she
ඇයි	why
ඇර	open
ඇරත්	otherwise
ඇරඹිණ	start
ඇරයුම	invitation
ඇල	bank
ඇලවීම	nap
ඇල්ම	like
ඇල්ලුවා	touch
ඇවිද	walk
ඇවිස්සීම	excitement
ඇස	eye
ඇසළ	july
ඇස්තමේන්තු	estimates
ඇසිණ	listened
ඇසුර	associate
ඇසුරිණි	packed
ඇසුරුම	packed
ඇසුව	hear
ඇහැ	eye
ඇහැරීමට	wakeup
ඇහිඳ	pick
ඇහිබැම	eyebrow
ඇළ	stream
ඈ	she
ඈත	far
ඈත්	distant
ඉංග්‍රිසි	enlish
ඉංජිනේරු	engineer
ඉක්බිත්තෙන්	then
ඉක්මණට	quick
ඉක්මවති	exceed
ඉකුත්	expire
ඉකුත්දා	yesterday
ගුරුතුමිය  teacher
ගුරුතුමා     teacher
ඉගිල	fly
ඉගෙන	learn
ඉඟි	hints
ඉඟුරු	ginger
ඉච්ඡා	hope
ඉටි	wax
ඉටිපන්දමක්	candle
ඉටුකර	achieve
ඉඩ	space
ඉඩම	land
ඉණිමං	ladder
ඉණිමෙන්	inning
ඉණෙහි	hip
ඉතසිතින්	hartiest
ඉත්තක්	sprig
ඉත්තැවා	porcupine
ඉතාලි	italy
ඉතිං	so
ඉතික්බිතිව	then
ඉතින්	so
ඉතිරි	save
ඉතිරී	overflow
ඉතිහාස	history
ඉතුරු	balance
ඉදිකටුවක්	needle
ඉදිකර	build
උද්ඝෝෂකයකු	Agitator
උද්ඝෝෂණ	agitation
උද්දාම	exaltation
උද්ධච්ඡ	popinjay
උද්ධමනයට	Inflation Inspiring 
උද්භිද	Botanical
උද්යෝගයක්	 Enthusiasm 
උද්යෝගිමත්	Enthusiastic 
උද්වේගකර	Inspiring
උද්‍යාන	park
උදාරය	great
උදාරහරණයක්	example
උදාහරණ	examples
උදැල්ල	mamoty
උදෑසන	Morning
උදුන්	cookers
උදුරගෙන	away from
උදෙසා	for
උනන්දුව	Interests
උන්ගේ	Their
උඳු	gram
උඳුනක	cooker
උඳුවප්	December
උප	vice
උපකරණ	equipment
උපකල්පන	assumption
උපක්‍රම	tactic
උපකාර	help
උපත	birth
උපද්‍රව	hazard
උපදෙස්	instruction
උපදේශ	advisor
උපන්	birth
උපයන	earn
උපරිම	maximum
උපාධි	degree
උපාධිධර	batchler
උමං	tunnel
උමග	tunnel
කකුළුවන්	crab
කකුළුවා	crab
කජු	cashew
කජුමද	cashew
කට	mouth
කටපාඩම්	learn by heart
කටයුත්කතකදි	activity
කටයුත්ත	activity
කටහඩ	voice
කට්ටලය	set
කටුව	prickle
කටුස්සකු	lizard
කඩකාමර	stall
කඩකිරීම	infraction
කඩදාසි	paper
කඩනවා	break
කඩය	shop
කණගාටු	regret
කණට	ear
කණඩායමේ	group
කණ්ණාඩි	mirror
කණිෂ්ට	junior
කණිෂ්ඨ	junior
කණුව	pillar
කණුවක්	pillar
කණුවල	pillar
කණුවෙ	pillar
කණේ	ear
කත	woman
කතන්දර	story
කතර	desert
කතාකරති	talk
කතාන්දර	story
කතානායක	speaker
කතාවකට	story
කතිර	cross
කතුවරයකු	author
කතෝලික	catholic
කන්තෝරු	office
කන්ද	mountain
කන්න	eat
කඳක	body
කඳවුරක	camp
කඳුලු	tear
කඳුවල	mountains
කපටි	cunning
කපති	cut
කපුටාගේ	crow
කම්කරු	labour
කම්බි	wire
කම්මල්කරුවා	blacksmith
කම්මැලිකම	laziness
කම්මුල	cheek
කම්හල	factory
කමිටු	comitee
විකෘති	Distorted
විඛාදනය	Corrosion
විගඩම	Tomfoolery
විගමන	Emigration
විගස	Immediately
විග්‍රහ	Analyze
විචලනය	Variation
විචාර	Reviews
විචාරක	Critics
විචාරය	Review
විචාරශීලි	Critical
විචිත්‍ර	Mosaic
විජයග්‍රහණ	Victory
විජලනය	Dehydration
විජ්ජාවක්	Hat
විජිතයේ	Colony
විටමින්	Vitamin
විඩාව	Fatigue
විතරක්	Only
විත්තිකරු	Accused
විත්තිය	NL
විද	Science
විදහා	Display
විද්වත්	Expert
වැවිලිකරු	Cultivator
වැස්මක	The veil
වැසිකිළිය	Toilet
වැසියෝ	People
වැසිවනාන්තර	Rainforest
වැසීම	Closing
වැසුම	Helmet
වැහැරීම	.As
වැහිබර	Evidence of
වැළකිම	Preventing
වැළඳගත්තා	Captivated
වැළඳීම	Eats
වැළඳෙන	Histoplasmosis
වැළඳේ	Shellfish
වැළපුණ	Laments
වැළපෙන	Mourning
වැළළුණා	Væuaḷuṇā
වැළැක්වීම	Prevention
වැළැකීම	Prevention
වෑංජන	Serve elaborate
වෑද්දුම්	Welding
වෑන්	Van
වෑයම	Effort
විකට	Comedy
විකල්පව	Alternately
විකලාංග	Orthopedic
විකසිත	Blossom
විකාර	Nonsense
විකාශය	Broadcast
විකිණිම	Selling
විකිරණය	Radiation
විකිරණශීලි	Radioactive
විකුණනවා	Selling
විකුණයි	Sells
විකුණුවා	Sold
වැන්දඹුව	Widow
වැනෙන	Drag
වැඳීම	Bowing
වැපිරීම	Sowing
වැය	spent
වැයකරන	Spent
වැයවෙන	The-
වැයුව	Theater
වැර	Correct
වැරදි	Wrong
වැරදිකරු	Found guilty
වැරදියි	FALSE
වැරදී	Wrong
වැරදීම	Err
වැරදුණ	Failures
වැරහැලි	Rags
වැල	Vine
වැලකිය	Prohibited
වැලකීම	Lack of
වැලපෙන	Mourning
වැලමිට	Elbow
වැලලීම	Unhealthy
වැලැක්වීම	Prevention
වැලි	Sand
වැලිතලාව	Sands
වැව	Tank
වැව්	Tanks
වැවිලි	Plantation
වැට	Fence
වැටක්	Fence
වැටකෙයියා	Væṭakeyiyā
වැටකොළු	Ridged
වැටලීම	Raid
වැටහෙනවා	Obviously
වැටිණි	Fell
වැටිලා	Down
වැටීම	Fall
වැටුණ	Fell
වැටුප	Salary
වැටෙන	Falling
වැඩ	work
වැඩකටයුතු	Proceedings
වැඩකරන	Working
වැඩක්	Work
වැඩකාරයා	Servant
වැඩදායක	Workable
වැඩපිළිවෙළ	Program
වැඩපොළට	Garage
වැඩබිමට	In the workplace
වැඩමුළුව	Workshop
වැඩවර්ජන	Strikes
වැඩසටහන	program
වැඩිපුර	More
වැඩිමහල්	Older
වැඩිවිය	Puberty
වැඩිවීම	Increase
වැඩිවුණා	Increased
වැඩිවෙයි	To increase
වැඩිහිටි	Adult
වැඩීම	growing up
වැඩුණු	Grown
වැඩුනු	Adult
වැඩෙනවා	grow up
වැද	This trend
වැදගත්	important
වැද්දා	Hunter
වැදිලා	Hit
වැදීම	Hit
වැදුණා	Hit
වැදෙයි	Hits the
වැනසෙයි	Overthrow
වාක්‍ය	Sentences
වාගේ	Almost
වාචාල	Rhetorically
වාචික	Oral
වාට්ටුව	Ward
වාඩිවන	Vadim
වාණිජ	Commerce
වාතය	Air
වාතාවරණයට	Environment
වාතාශ්‍රය	Ventilation
වාදක	Orchestra
වාදනය	Play
වාදය	Theory
වාදි	Hangover
වානිජ	Commercial
වායු	Air
වායුගෝලය	Atmosphere
වායුව	Gas
වායුසමනය	AC
වායුසමීකරණය	Air conditioning
වාරණය	Censorship
වාරය	Season
වාර්තා	reports
වාර්තාකරණය	Reporting
වාර්තාකරු	Reporter
වාර්ෂිකව	Annually
වාරිමාර්ග	Irrigation
වාරුව	Stick
වාෂ්පය	Vapors
වාසනාව	Good luck
වාස්තු	Architects
වාස්තුවිද්‍යා	Architectural
වාසිත්	Benefits
වාසිදායක	Favorable
වාසිය	The advantage
වාසී	Aboriginal
වාසීන්	Residents
වාසුළි	Cyclones
වාහකයන්	Carriers
වාහන	Vehicles
වාහනෙන්	Shocked,
වාහනේ	Car
වැජඹෙති	Wave
වැජඹෙන	Pinkett
වැජැඹෙයි	Væjæm̆beyi
වළලනවා	Excrement
වළල්ල	Ring
වළලු	Rings
වළවල්	Graves
වළාකුළු	Cloud
වළිකුකුළා	Pheasant
වළින්	Stalls
ව්‍යංජනය	Stew
ව්‍යවස්ථාදායක	Legislative
ව්‍යවස්ථානුකූල	Constitutional
ව්‍යවස්ථාව	the Constitution
ව්‍යවසායක	Entrepreneur
ව්‍යවහාරික	Applied
ව්‍යසනයට	Disaster
ව්‍ය්‍යාපාර	Chamber
ව්‍ය්‍යාපාරික	Chambers
ව්‍යාංගාර්ථයෙන්	Vyāṁgārthayen
ව්‍යාංජනය	Curry
ව්‍යාකරණ	Grammar
ව්‍යාකූල	Confused
ව්‍යාඝ්‍රයා	CAT
ව්‍යාජ	FALSE
ව්‍යාධිය	Disease
ව්‍යාප්ත	Spread
ව්‍යාප්තිය	Distribution
ව්‍යාපාර	business
ව්‍යාපාරක	Business
ව්‍යාපාරගෙන	Business
ව්‍යාපාරය	business
ව්‍යාපාරිකයා	Businessman
ව්‍යාපෘතිය`	Vyāpṛtiya`
ව්‍යායාම	Exercise
ව්‍යායාම්	Exercise
ව්‍යාර්ථ	Passing
ව්‍යාවහාර	Practiced
ව්‍යුහගත	Structured
ව්‍යුහය	structure
වරාය	Port
වරුව	Ceasing
වරෙන්තුව	Warrant
වල	in
වලංගු	Valid
වලකින	Refrain
වලලු	Ring
වලව්ව	Walawwa
වලසා	the bear
වලහා	Bear
වල්ගය	Tail
වල්පැළෑටි	Weeds
වලාකුළු	Cloud
වලි	Jungle
වලිකුකුළා	Valikukuḷā
වලිගය	Tail
වවන	Grown
වශයෙන්ම	A
වශී	Charm
වස	Poison
වසංකිරීම	Conceal
වසඟ	Charms
වසන්තය	the spring
වසම	Domain
වසර	the year
වස්ත්‍රයක්	Garment
වස්තුව	Wealth
වස්සාන	For spring
වසා	Closed
වහන්න	Close
වහරන	Sociology
වහල	the roof
වහලෙක්	Slave
වහළක්	Roof
වහා	Immediately
වහාම	Immediately
වහින	The rain
වළං	Pottery
වළකා	Preventing
වළකින්න	Avoid
වන්දිය	Compensation
වනාන්තරය	Forest
වනිතා	Women
වනෝද්‍යානය	Park
වඳවීම	Corral
වඳින්න	Bow
වඳුරා	Monkey
වපර	Distrust
වපසරිය	Extent
වපුරාලීමට	Vapurālīmaṭa
වමත	Left
වමනය	Vomiting
වම්	The left
වයඹ	North West
වයස	age
වයස්ගතවීම	Aging
වයිරස	Virus
වයිරස්	Virus
වයෝවෘධ	Strangled
වරකදී	Clutch
වරද	Offense
වරදකරු	Convicted
වරදක්	Offense
වරදවා	Misunderstood
වරද්දන්න	Sarajevo
වරප්‍රසාදය	Privilege
වරම්	Opportunity
වරල	Fin
වරහන්	Brackets
වර්ග	types
වර්ගඵලය	Area
වර්ගමූලයට	Square root
වර්ගය	Category
වර්ගීකරණය	Classification
වර්ජනය	strike
වර්ණ	Colours
වර්ණාවලිය	Spectra
වර්තනය	Refraction
වර්තමානය	Present
වර්ථමාන	Current
වර්ධනය	development
වර්ෂය	the year
වර්ෂාපතනය	Rainfall
වර්ෂාව	Rain
වකවානුව	Deadline
වක්‍රාකාර	Round
වකුගඩු	Kidney
වගඋත්තරකරු	Respondent
වගකිවයුතු	Responsible
වගකීම්	Responsibilities
වගන්ති	Sections
වගබලා	Sure
වගාකරුවා	Farming
වගාව	Cultivation
වගුව	Table
වචනය	the word
වට	Round
වටකර	Round
වටපිටාව	Surroundings
වටය	Round
වටයක්	Round
වටලා	Raided
වටවී	Surrounded
වටහා	Understood
වට්ටක්කා	Pumpkin
වට්ටම්	Discount
වට්ටි	Ie
වට්ටෝරුව	Recipe
වටා	Around
වටිනා	valuable
වටේ	Around
වඩදිය	Tide
වඩාත්	the most
වඩිනවා	Moment
වඩුවා	Carpenter
වත්කම්	assets
වත්කරනවා	Pouring
වත්ත	Estate
වත්මත්	Will pave
වතාවරණය	Climate
වතුපිටි	Real estate
වතුයාය	Estate
වතුර	Water
වදකයා	Brings
වදමල්	Hibiscus
වදින්න	Coming to
වදියි	Fights
වධහිංසා	Torture
වනජීවි	Wildlife
වනන්න	Wave
වනය	Forest
වනරොද	Vanaroda
වනලා	Vanalā
වනලැහැබ	Vanalæhæba
වනවදුලු	Woods
වනවා	Will
වනවාසී	Wanawasi
වනසංරක්ෂණ	The wildlife
වනසතුන්	Wild animals
වන්දනාව	Worship
ලිස්සීම	Liz
ලිහිල්	Loose
ලිහිසි	Lubricant
ලී	Wood
ලීටර	Liters
ලීය	Wood
ලීවේ	Wrote
ලීසිං	Leasing
ලුහුඬු	Classified
ලුහුබැඳ	Track
ලූණු	Onion
ලූනු	Onions
ලෙංගතු	.American
ලෙඩ	Sick
ලෙඩ්ඩු	Patients
ලෙඩේ	Illness
ලෙණ	Leṇa
ලෙන්ගතු	Loyalty
ලෙල්ල	Husk
ලෙලි	Husk
ලෙසකින්	Otherwise
ලෙහෙසි	Easy
ලෙහෙසිය	Easy
ලෙළෙන	Leḷena
ලේ	blood
ලේකම්	Secretary
ලේඛකයා	Writer
ලේන්සු	Handkerchiefs
ලේබලය	Label
ලේලි	daughter in law
ලේසියි	Easy
ලොක්කා	Boss
ලොකු	Big
ලොකුකමක්	Poop
ලොකුම	biggest
ලොතරැයි	Lottery
ලෝකඩ	Bronze
ලෝකප්‍රකට	Best known
ලෝකවාසී	The worlds
ලෝකෙ	The world
ලෝභ	Stinginess
ලෝලියකු	Savvy
ලෝහය	The metal
ලෞකික	Secular
වංගුව	Bend
වංචාකාරයා	Treacherous
වංචාව	Fraud
වංශය	House
වංශවත්	The nobles
ලාච්චු	drawers
ලාබාල	Young
ලාභ	profit
ලාභාංශ	Dividend
ලාම්පුව	Lamp
ලැග	Nesting
ලැගිම	Nesting
ලැගුම්හල	Lodge
ලැජ්ජාව	Shame
ලැදි	Loving
ලැදියාව	Loyalty
ලැබීම	To
ලැබුණා	Received
ලැබුවා	Was
ලැබෙනවා	Will
ලැබේ	Are
ලැයිස්තුව	List
ලැහැබ්	 forests
ලැහැස්ති	Ready
ලෑල්ල	Board
ලෑලි	Tablets
ලෑස්තියි	Ready
ලිඛිත	Written
ලිඳක්	Well
ලිප	Hearth
ලිපිකවර	Lipikavara
ලිපිගොනුව	File
ලිපිනය	Address
ලිපිය	the letter
ලිය	Liya
ලියකියවිලි	Documents
ලියනවා	Write
ලියන්න	Write
ලියාපදිංචි	The registration
ලියුං	Liu
ලියුකේමියා	Leukemia
ලියුම	Letter
ලියුම්	Letters
ලියුම්කරු	Writer
ලිවීම	Writing
ලිස්සන	Slippery
විකෘති	Distorted
විඛාදනය	Corrosion
විගඩම	Tomfoolery
විගමන	Emigration
විගස	Immediately
විග්‍රහ	Analyze
විචලනය	Variation
විචාර	Reviews
විචාරක	Critics
විචාරය	Review
විචාරශීලි	Critical
විචිත්‍ර	Mosaic
විජයග්‍රහණ	Victory
විජලනය	Dehydration
විජ්ජාවක්	Hat
විජිතයේ	Colony
විටමින්	Vitamin
විඩාව	Fatigue
විතරක්	Only
විත්තිකරු	Accused
විත්තිය	NL
විද	Science
විදහා	Display
විද්වත්	Expert
වැවිලිකරු	Cultivator
වැස්මක	The veil
වැසිකිළිය	Toilet
වැසියෝ	People
වැසිවනාන්තර	Rainforest
වැසීම	Closing
වැසුම	Helmet
වැහැරීම	.As
වැහිබර	Evidence of
වැළකිම	Preventing
වැළඳගත්තා 	Captivated
වැළඳීම	 Eats
වැළඳෙන	Histoplasmosis
වැළඳේ	Shellfish
වැළපුණ	Laments
වැළපෙන	Mourning
වැළළුණා	Væuaḷuṇā
වැළැක්වීම	Prevention
වැළැකීම	Prevention
වෑංජන	Serve elaborate
වෑද්දුම්	Welding
වෑන්	Van
වෑයම	Effort
විකට	Comedy
විකල්පව	Alternately
විකලාංග	Orthopedic
විකසිත	Blossom
විකාර	Nonsense
විකාශය	Broadcast
විකිණිම	Selling
විකිරණය	Radiation
විකිරණශීලි	Radioactive
විකුණනවා	Selling
විකුණයි	Sells
විකුණුවා	Sold
වැන්දඹුව	Widow
වැනෙන	Drag
වැඳීම	Bowing
වැපිරීම	Sowing
වැය	spent
වැයකරන	Spent
වැයවෙන	The-
වැයුව	Theater
වැර	Correct
වැරදි	Wrong
වැරදිකරු	Found guilty
වැරදියි	FALSE
වැරදී	Wrong
වැරදීම	Err
වැරදුණ	Failures
වැරහැලි	Rags
වැල	Vine
වැලකිය	Prohibited
වැලකීම	Lack of
වැලපෙන	Mourning
වැලමිට	Elbow
වැලලීම	Unhealthy
වැලැක්වීම	Prevention
වැලි	Sand
වැලිතලාව	Sands
වැව	Tank
වැව්	Tanks
වැවිලි	Plantation
වැට	Fence
වැටක්	Fence
වැටකෙයියා	Væṭakeyiyā
වැටකොළු	Ridged
වැටලීම	Raid
වැටහෙනවා	Obviously
වැටිණි	Fell
වැටිලා	Down
වැටීම	Fall
වැටුණ	Fell
වැටුප	Salary
වැටෙන	Falling
වැඩ	work
වැඩකටයුතු	Proceedings
වැඩකරන	Working
වැඩක්	Work
වැඩකාරයා	Servant
වැඩදායක	Workable
වැඩපිළිවෙළ	Program
වැඩපොළට	Garage
වැඩබිමට	In the workplace
වැඩමුළුව	Workshop
වැඩවර්ජන	Strikes
වැඩසටහන	program
වැඩිපුර	More
වැඩිමහල්	Older
වැඩිවිය	Puberty
වැඩිවීම	Increase
වැඩිවුණා	Increased
වැඩිවෙයි	To increase
වැඩිහිටි	Adult
වැඩීම	growing up
වැඩුණු	Grown
වැඩුනු	Adult
වැඩෙනවා	grow up
වැද	This trend
වැදගත්	important
වැද්දා	Hunter
වැදිලා	Hit
වැදීම	Hit
වැදුණා	Hit
වැදෙයි	Hits the
වැනසෙයි	Overthrow
වාක්‍ය	Sentences
වාගේ	Almost
වාචාල	Rhetorically
වාචික	Oral
වාට්ටුව	Ward
වාඩිවන	Vadim
වාණිජ	Commerce
වාතය	Air
වාතාවරණයට	Environment
වාතාශ්‍රය	Ventilation
වාදක	Orchestra
වාදනය	Play
වාදය	Theory
වාදි	Hangover
වානිජ	Commercial
වායු	Air
වායුගෝලය	Atmosphere
වායුව	Gas
වායුසමනය	AC
වායුසමීකරණය	Air conditioning
වාරණය	Censorship
වාරය	Season
වාර්තා	reports
වාර්තාකරණය	Reporting
වාර්තාකරු	Reporter
වාර්ෂිකව	Annually
වාරිමාර්ග	Irrigation
වාරුව	Stick
වාෂ්පය	Vapors
වාසනාව	Good luck
වාස්තු	Architects
වාස්තුවිද්‍යා	Architectural
වාසිත්	Benefits
වාසිදායක	Favorable
වාසිය	The advantage
වාසී	Aboriginal
වාසීන්	Residents
වාසුළි	Cyclones
වාහකයන්	Carriers
වාහන	Vehicles
වාහනෙන්	Shocked,
වාහනේ	Car
වැජඹෙති	Wave
වැජඹෙන	Pinkett
වැජැඹෙයි	Væjæm̆beyi
වළලනවා	Excrement
වළල්ල	Ring
වළලු	Rings
වළවල්	Graves
වළාකුළු	Cloud
වළිකුකුළා	Pheasant
වළින්	Stalls
ව්‍යංජනය	Stew
ව්‍යවස්ථාදායක	Legislative
ව්‍යවස්ථානුකූල	Constitutional
ව්‍යවස්ථාව	the Constitution
ව්‍යවසායක	Entrepreneur
ව්‍යවහාරික	Applied
ව්‍යසනයට	Disaster
ව්‍ය්‍යාපාර	Chamber
ව්‍ය්‍යාපාරික	Chambers
ව්‍යාංගාර්ථයෙන්	Vyāṁgārthayen
ව්‍යාංජනය	Curry
ව්‍යාකරණ	Grammar
ව්‍යාකූල	Confused
ව්‍යාඝ්‍රයා	CAT
ව්‍යාජ	FALSE
ව්‍යාධිය	Disease
ව්‍යාප්ත	Spread
ව්‍යාප්තිය	Distribution
ව්‍යාපාර	business
ව්‍යාපාරක	Business
ව්‍යාපාරගෙන	Business
ව්‍යාපාරය	business
ව්‍යාපාරිකයා	Businessman
ව්‍යාපෘතිය`	Vyāpṛtiya`
ව්‍යායාම	Exercise
ව්‍යායාම්	Exercise
ව්‍යාර්ථ	Passing
ව්‍යාවහාර	Practiced
ව්‍යුහගත	Structured
ව්‍යුහය	structure
වරාය	Port
වරුව	Ceasing
වරෙන්තුව	Warrant
වල	in
වලංගු	Valid
වලකින	Refrain
වලලු	Ring
වලව්ව	Walawwa
වලසා	the bear
වලහා	Bear
වල්ගය	Tail
වල්පැළෑටි	Weeds
වලාකුළු	Cloud
වලි	Jungle
වලිකුකුළා	Valikukuḷā
වලිගය	Tail
වවන	Grown
වශයෙන්ම	A
වශී	Charm
වස	Poison
වසංකිරීම	Conceal
වසඟ	Charms
වසන්තය	the spring
වසම	Domain
වසර	the year
වස්ත්‍රයක්	Garment
වස්තුව	Wealth
වස්සාන	For spring
වසා	Closed
වහන්න	Close
වහරන	Sociology
වහල	the roof
වහලෙක්	Slave
වහළක්	Roof
වහා	Immediately
වහාම	Immediately
වහින	The rain
වළං	Pottery
වළකා	Preventing
වළකින්න	Avoid
වන්දිය	Compensation
වනාන්තරය	Forest
වනිතා	Women
වනෝද්‍යානය	Park
වඳවීම	Corral
වඳින්න	Bow
වඳුරා	Monkey
වපර	Distrust
වපසරිය	Extent
වපුරාලීමට	Vapurālīmaṭa
වමත	Left
වමනය	Vomiting
වම්	The left
වයඹ	North West
වයස	age
වයස්ගතවීම	Aging
වයිරස	Virus
වයිරස්	Virus
වයෝවෘධ	Strangled
වරකදී	Clutch
වරද	Offense
වරදකරු	Convicted
වරදක්	Offense
වරදවා	Misunderstood
වරද්දන්න	Sarajevo
වරප්‍රසාදය	Privilege
වරම්	Opportunity
වරල	Fin
වරහන්	Brackets
වර්ග	types
වර්ගඵලය	Area
වර්ගමූලයට	Square root
වර්ගය	Category
වර්ගීකරණය	Classification
වර්ජනය	strike
වර්ණ	Colours
වර්ණාවලිය	Spectra
වර්තනය	Refraction
වර්තමානය	Present
වර්ථමාන	Current
වර්ධනය	development
වර්ෂය	the year
වර්ෂාපතනය	Rainfall
වර්ෂාව	Rain
වකවානුව	Deadline
වක්‍රාකාර	Round
වකුගඩු	Kidney
වගඋත්තරකරු	Respondent
වගකිවයුතු	Responsible
වගකීම්	Responsibilities
වගන්ති	Sections
වගබලා	Sure
වගාකරුවා	Farming
වගාව	Cultivation
වගුව	Table
වචනය	the word
වට	Round
වටකර	Round
වටපිටාව	Surroundings
වටය	Round
වටයක්	Round
වටලා	Raided
වටවී	Surrounded
වටහා	Understood
වට්ටක්කා	Pumpkin
වට්ටම්	Discount
වට්ටි	Ie
වට්ටෝරුව	Recipe
වටා	Around
වටිනා	valuable
වටේ	Around
වඩදිය	Tide
වඩාත්	the most
වඩිනවා	Moment
වඩුවා	Carpenter
වත්කම්	assets
වත්කරනවා	Pouring
වත්ත	Estate
වත්මත්	Will pave
වතාවරණය	Climate
වතුපිටි	Real estate
වතුයාය	Estate
වතුර	Water
වදකයා	Brings
වදමල්	Hibiscus
වදින්න	Coming to
වදියි	Fights
වධහිංසා	Torture
වනජීවි	Wildlife
වනන්න	Wave
වනය	Forest
වනරොද	Vanaroda
වනලා	Vanalā
වනලැහැබ	Vanalæhæba
වනවදුලු	Woods
වනවා	Will
වනවාසී	Wanawasi
වනසංරක්ෂණ	The wildlife
වනසතුන්	Wild animals
වන්දනාව	Worship
ලිස්සීම	Liz
ලිහිල්	Loose
ලිහිසි	Lubricant
ලී	Wood
ලීටර	Liters
ලීය	Wood
ලීවේ	Wrote
ලීසිං	Leasing
ලුහුඬු	Classified
ලුහුබැඳ	Track
ලූණු	Onion
ලූනු	Onions
ලෙංගතු	.American
ලෙඩ	Sick
ලෙඩ්ඩු	Patients
ලෙඩේ	Illness
ලෙණ	Leṇa
ලෙන්ගතු	Loyalty
ලෙල්ල	Husk
ලෙලි	Husk
ලෙසකින්	Otherwise
ලෙහෙසි	Easy
ලෙහෙසිය	Easy
ලෙළෙන	Leḷena
ලේ	blood
ලේකම්	Secretary
ලේඛකයා	Writer
ලේන්සු	Handkerchiefs
ලේබලය	Label
ලේලි	daughter in law
ලේසියි	Easy
ලොක්කා	Boss
ලොකු	Big
ලොකුකමක්	Poop
ලොකුම	The biggest
ලොඩනැගිල්ල	Loḍanægilla
ලොතරැයි	Lottery
ලෝකඩ	Bronze
ලෝකප්‍රකට	Best known
ලෝකවාසී	The worlds
ලෝකෙ	The world
ලෝභ	Stinginess
ලෝලියකු	Savvy
ලෝහය	The metal
ලෞකික	Secular
වංගුව	Bend
වංචාකාරයා	Treacherous
වංචාව	Fraud
වංශය	House
වංශවත්	The nobles
ලාච්චු	drawers
ලාබාල	Young
ලාභ	profit
ලාභාංශ	Dividend
ලාම්පුව	Lamp
ලැග	Nesting
ලැගිම	Nesting
ලැගුම්හල	Lodge
ලැජ්ජාව	Shame
ලැදි	Loving
ලැදියාව	Loyalty
ලැබීම	To
ලැබුණා	Received
ලැබුවා	Was
ලැබෙනවා	Will
ලැබේ	Are
ලැයිස්තුව	List
ලැහැබ්	 forests
ලැහැස්ති	Ready
ලෑල්ල	Board
ලෑලි	Tablets
ලෑස්තියි	Ready
ලිඛිත	Written
ලිඳක්	Well
ලිප	Hearth
ලිපිකවර	Lipikavara
ලිපිගොනුව	File
ලිපිනය	Address
ලිපිය	the letter
ලිය	Liya
ලියකියවිලි	Documents
ලියනවා	Write
ලියන්න	Write
ලියාපදිංචි	The registration
ලියුං	Liu
ලියුකේමියා	Leukemia
ලියුම	Letter
ලියුම්	Letters
ලියුම්කරු	Writer
ලිවීම	Writing
ලිස්සන	Slippery
2/5/2016	
ලත්තෑරුමක්	Lattǣrumak
ලතෝනි	The epoch
ලදී	Was
ලන්ද	Hainyaya
ලන්දේසීන්	Dutch
ලන්සුවක්	Bid
ලනු	Extruded
ලඳුන්	Ladies
ලපයක්	Spots
ලබන	The
ලබනවා	Will
ලබාගන්නවා	Get
ලබාගැනීම	Obtain a
ලබාදෙන්න	Submit
ලබැගැනීම	Labægænīma
ලබු	Gourd
ලම්බකය	Lumb
ලම්භකව	Boner
ලය	Module
ලයිට්	Light
ලවණ	Salts
ලවන	Mineral
ලවය	The denominator
ලව්වා	Willpower
ලවා	By
ලස්සන	Beautiful
ලස්සනම	most beautiful
ලස්සනයි	Beautiful
ල්‍රුණු	Lruṇu
ලාංකිකයා	Lankan
ලාංකීක	Lankan
ලාංකීය	Lanka
ලාංකේය	Lanka
ලාංඡනය	Logo
ලාක්ෂණික	Characteristic
රෝග	disease
රෝගය	Disease
රෝගාතුර	Ill
රෝගාබාධ	Diseases
රෝගීන්	Patients
රෝද	Wheel
රෝදපුටුවක්	Wheelchair
රෝදය	The wheel
රෝපණය	Planted
රෝල	Rolling
රෝල්ස්	Rolls
රෝස	Pink
රෝසමල්	Roses
රෝහල	Hospital
රෞද්‍ර	Oppressive
ලංකාව	Lanka
ලක්කිරීම	Neuter
ලක්දිව	Lakdiva
ලක්වුණා	Pedestal
ලක්වූ	Victim
ලක්වෙලා	Confronted
ලක්ෂණය	Feature
ලක්ෂය	Point
ලක්ෂ්‍යය	Point
ලකුණ	Mark
ලකුණු	score
ලගිනවා	Haunters
ලඟ	Have
ලඟින්	Close
ලජ්ජාවට	Shame
ලට	FSC
ලණු	Ropes
ලතවුණා	Latavuṇā
රුව	Beauty
රූකඩ	Puppets
රූගත	Shooting
රූපය	Image
රූපලාවන්‍ය	Beauty
රූපවාහිනී	television
රූපශ්‍රීය	Beauty
රූපාලාවන්‍ය	Rūpālāvanya
රූමත්	Beautiful
රූරා	Trills
රූල්	Rūl
රූස්ස	Swathe
රෙගුලාසි	Regulations
රෙජිමේන්තුවද	Regiment
රෙජිස්ට්‍රාර්	Registrar
රෙජිෆෝම්	Rigifoam
රෙද්ද	Fuck
රෙදි	Textiles
රෙදිපිළි	Textiles
රෙස්ටුරන්ට්	Restaurant
රෙසිඩන්ට්	Resident
රේඛාව	Line
රේගුව	Customs
රේඩාර්	Radar
රේඩියේටරය	Radiator
රේඩියෝ	Radio
රේණුවක්	Failed him
රේන්ද	Lace
රේල්පාර	Rēlpāra
රේස්	Race
රොකට්ටුව	Rocket
රොක්වීම	Rock
රොටි	Bread
රොටී	Roti
රොඩු	Litter
රොත්ත	The bulk
රොදක්	Wind
රොබෝ	Robot
රැහැන	Rope
රැළ	Flock
රැළිය	Rally
රෑට	Night
රෑන	Rǣna
රිංගනවා	Cannes
රිටි	Pole vault
රිද්මය	Rhythm
රිදී	Silver
රිදෙනවා	Hurts
රිබන්	Ribbons
රිමාන්ඩ්	Remanded
රිය	Accident
රියදුරු	Driver
රියැදුරා	Driver
රියැදුරු	Driving
රිලවා	Monkey
රිලා	The monkey
රිවෝල්වරය	Revolver
රිසි	Intended
රිසියෙන්	Standing
රිළවුන්	Peacocks
රීතිය	Genre
රුක්	Tree
රුකුලක්	Help
රුචිකත්වය	Preference
රුචිය	Appetite
රුදු	Madame
රුදුරු	Devastating
රුධිරගත	Blood
රුධිරය	Blood
රුපවාහිනි	Televisions
රුප්පාව	The causal
රුපියල්	Rs
රාත්‍රීය	Night
රාමුව	Framework
රාලහාමි	Rālahāmi
රාවය	Rawaya
රාශීය	Too
රාළහාමි`	Rāḷahāmi`
රැකගන්න	Safeguard
රැකගෙන	Integrity
රැකවරණය	Protection
රැකවල්	Guard
රැකියාව	Occupation
රැකීම	Protect
රැකීරක්ෂා	Employment
රැකෙනවා	Keeping our
රැගෙන	Take
රැඟුම්	Performances
රැජින	Queen
රැඳවියන්	Detainees
රැඳවුණ	Detention
රැඳවුම්කරුවන්ට	Detention
රැඳෙන	Memorable
රැය	Night
රැල්ල	Wave
රැලි	Rally
රැවටිල්ල	The deceit
රැවටීම	Deception
රැවුල	Beard
රැස	Range
රැසක	Several
රැස්	Together
රැස්කිරීම	Collection
රැස්වීම	meeting
රැස්වීම්	Meetings
රැස්වුණ	Consist
රැස්වුණු	Sittings
රවුම්	Round
රස	Taste
රසකාරක	Flavoring
රසකැවිලි	Sweets
රසදිය	Mercury
රසය	Flavor
රසවත්	Delicious
රසවිඳීමට	Those present
රස්තියාදු	Loafing
රස්නෙයි	Hot
රස්සාව	Job
රසායනාගාරය	Laboratory
රසායානාගාර	Dicyandiamide
රසායානික	NEXAVAR
රසාලිප්ත	Alchemy
රසිකයා	Spectator
රහස	Secret
රහස්‍ය	Confidential
රහස්‍යභාවය	Confidentiality
රහසිගතව	Secret
රහසින්	Secret
රළක්	Massif
රළවලින්	Broadside
රළු	Rough
රාක්ක	Shelves
රාජකාරිය	Duty
රාජකාරී	Duties
රාජකීය	Royal
රාජධානිය	Kingdom
රාජ්‍ය	state
රාජ්‍යත්වයට	Rājyatvayaṭa
රාජ්‍යතාන්ත්‍රික	Diplomatic
රාජ්‍යයය`	Rājyayaya`
රාජාණ්ඩුව	Monarchy
රාජාලියා	Eagle
රාත්තල්	Pounds
රටාව	Pattern
රටේ	of the country
රණකාමි	Warrior
රණ්ඩු	Fight
රත්කරන	Heated
රත්කළ	Heating
රත්තරං	Gold
රත්වීම	Heat
රත්වෙන	Heating pad
රත්‍රං	Gold
රත්‍රන්	Gold
රතාක්පූර්	Ratākpūr
රතිඤ්ඤා	Crackers
රතුපාට	Red
රතුපැහැ	Red
රථ	Cars
රථගාල	Car park
රථය	Car
රදළ	Nobility
රන්	Gold
රන්වන්	Gold
රඳවා	Detention
රඳවාගෙන	Detained
රබර්	Rubber
රබාන	Tambourine
රමණීය	Beautiful
රඹුටන්	Rambutan
රයිස්	Rice
රයිෆලය	Rifle
රලු	Brusquely
රවටන	Cheating
රවටා	Deceive
රවා	Gape
යෞවනය	Adolescence
යෞවනියක	Youth
රංගනය	Acting
රංචුව	The herd
රක්තපාත	Hemorrhagic
රක්තාණු	HTR
රක්ෂණය	Insurance
රක්ෂා	Keeping
රක්ෂිතය	Reserve
රකින	Keeper
රකින්න	Protect
රකී	Says nothing
රකුසෙකු	Monster
රගර්	Rugby
රග්බි	Rugby
රඟන	Shooting
රඟපානවා	Rehearse
රඟපෑම	Acting
රචනාව	Essay
රජතුමා	the king
රජය	government
රජවරු	Kings
රජවාසල	The royal house
රජ්ජුරුවන්ට	The king
රජා	King
රජු	King
රජෙක්	King
රට	Country
රටකජු	Groundnut
රටපාලනය	Ruled the
රටපුරා	Country
රටවල්	countries
රටවැසියා	Citizens
යුගළ	Pair
යුත්තෝ	Outpouring
යුතුකම්	Obligations
යුතුය	must
යුතුවෙයි	Specify
යුදබිම	Toll
යුදවැදී	To relinquish
යුදශිල්පයද	Yudaśilpayada
යුද්ධය	war
යුද්ධාධිකරණය	Martial
යුධ	Army
යුධකාමි	Yudhakāmi
යුධහමුදා	Army
යුවතිය	Girl
යුවළ	Couple
යුෂ්මතා	Yuṣmatā
යුහුසුළු	Busy
යූරෝපීය	European
යෙදීම	Fixing
යෙදුණා	Immoral
යෙදූණු	Iced
යෙදෙනවා	Nice
යෙදෙන්න	Keep
යෙහෙළිය	Friend
යොදය	Cream
යොදවන	Commercial
යොදාගන්නා	use
යොදාගැන්ම	Use
යොමුකිරීම	Redirecting
යොමුවීම	Focus
යොමුවු	Turns
යෝගට්	Yogurt
යෝග්‍ය	Friendly
යෝගී	Yoga
යෝගීන්	Soon spread
යෝජනාව	the proposal
යෝජිත	proposed
යෝධ         	Giant
යෝධයා	The giant
යහපාලනය	Good
යහපැවැත්ම	Wellness
යහමින්	Handsomely
යහළුවා	Friend
යහළුවෝ	Friends
යළි	Again
යළිත්	Again
යළිදු	Again
යාකර	Annexation
යාගය	Offering
යාචකයෙක්	Yācakayek
යාඥාව	Prayer
යාත්‍රාව	Vessel
යාතිකාව	Chant
යානය	Flight
යාන්තම්	Just
යාන්ත්‍රණය	Mechanism
යාන්ත්‍රික	Mechanical
යානාව	Interview
යාබද	Adjoining
යාම	To
යාමට	to go
යාමය	Watch
යාය	Yaya
යායුතු	Go
යාර	Yards
යාවජීව	Lifetime
යාවත්කාලීන	Update
යාළුකම	Friends
යාළුයි	A rumor
යාළුවා	Friend
යාළුවෝ	Friends
යැදීම	Appeal
යැපෙනවා	Cleave
යැව්වා	Sent
යැවීම	Sending
යෑම	Crossing
යුක්ත	Character
යුක්තවූ	Justice
යුක්තිගරුක	Just
යුක්තිය	Justice
යුග	Ages
යුගදිවි	Yugadivi
යුගය	Era
යුගල	Doubles
යුගලය	Pair
යථාර්ථවාදී	Realistic
යන	The
යනතුරු	Lively
යනවා	Going
යනවිට	Yanaviṭa
යන්තම්	Just
යන්තමින්	Barely
යන්ත්‍ර	Machines
යන්ත්‍රානුසාරයෙන්	Mechanical
යන්ත්‍රික	Machines
යන්ත්‍රෝපකරණ	Machinery
යන්න	Go
යනාදිය	Etc.
යනු	Is
යනුවෙන්	Said
යමකින්	Something
යම්	Some
යම්කිසි	Any
යමුද	Shall
යමෙක්	Someone
යයි`	Yayi`
යලි	Again
යලිත්	Again
යවනවා	Sends
යවන්න	Send
යවන්නා	Bowler
යවලා	Sent
යවා	Sent
යහ	Good
යහගුණ	Qualities
යහතින්	Properly
යහධර්ම	Yahadharma
යහනට	Bed
යහන්	Beds
යහපත	Good
යහපත්	good
මොළේ	Brains
මෝඩයා	you idiot
මෝදර	Modera
මෝදුවන	The making
මෝය	Mouth
මෝරා	Shark
මෝල	Mill
මෝසම්	Monsoon
මෝස්තරය	Design
මෝහනයට	Tse
මෝහය	Moha
ඹෟෂධ	Pharmaceuticals
යං	Young
යකඩ	Iron
යකඩය	Iron
යකදුරු	Yakaduru
යක්ෂයා	Devil
යක්ෂාවේශයක්	Pixie
යකෙක්	Demonized
යගුලිය	Putt
යට	Subject
යටතට	Under the
යටත්	Subject
යටත්විජිතවාදී	Colonial
යටත්වීම	Surrender
යටතේ	Under the
යටපත්	Suppression
යටවීම	Flooding
යටවෙනවා	Bow down
යටහත්	Humble
යටිකුරු	DOWN
යටින්	Underlying
යටිහිත	Subconscious
යත්න	Attempted
යත්නම්	Attempted
යතුර	Key
යථා	Recovery
යථාර්ථය	Reality
මේක	This
මේද	Fat
මේදය	Fat
මේන්න	Scolded
මේනිසා	Therefore,
මේරීම	Maturation
මේවා	these are
මේවිට	Mavis
මේසන්	Mason
මේසන්වරයකු	Mēsanvarayaku
මේසපන්දු	Table Tennis
මේසය	the table
මේස්	Socks
මේසේ	Table
මෛත්‍රිය	Kindness
මොකක්ද	What
මොකටද	Why
මොකද	What
මොකුත්	Nothing
මොට	Dull
මොට්ටු	Knobs
මොණරු	Danced
මොන	What
මොනවාද	What
මොනාද	What
මොනාහරි	Something
මොලය	Brain
මොල්ලිය	Thx
මොලේ	Brain
මොලොක්	Moloch
මොවුන්	They
මොහු	This
මොහොත	Moment
මොහොතේ	Moment
මොළකරු	Mastermind
මොළකාරයා	Masterminding
මොළය	The brain
මෙට්ටය	Mattress
මෙතරම්	So
මෙතැන	Here
මෙතුමිය	Ever
මෙතෙර	CMA
මෙනෙවිය	Ms.
මෙනෙහි	Meditation
මෙපමණ	So
මෙම	These
මෙමගින්	This
මෙයා	She
මෙරට	Country
මෙල්ල	Tame
මෙලෙක්	Melech
මෙලෙස	The
මෙලොව	World
මෙවර	The
මෙවලම්	Tools
මෙවැනි	such
මෙවිට	Thereupon
මෙසේ	The
මෙසේය	As follows:
මෙහා	Move
මෙහාට	Here
මෙහි	in here
මෙහිදී	The
මෙහෙයක්	Strategically
මෙහෙයවීම	Handling
මෙහෙයුමක්`	Meheyumak`
මෙහෙයුමට	Operation
මෙහෙයුම්	Operations
මෙහෙවර	Mission
මෙහෙසිය	Mahesi
මෙහේ	Here
මෙළෙක්	Malleable
මෙළොව	Childbirth for
මේ	This
මේඅතර	Meanwhile
මූත්‍රා	Urine
මූනිස්සම්	Ammunition
මූර්ඡා	Blackouts
මූර්තිය	Sculpture
මූල	Source
මූලද්‍රව්‍ය	Elements
මූලධර්ම	Principles
මූලධර්මවාදී	Fundamentalist
මූලය	Source
මූලර්ධම	Mūlardhama
මූලස්ථානය	Headquarters
මූල්‍ය	Finance
මූල්‍යමය	Financially
මූල්‍යාධාර	Assistance
මූලාධාර	Mūlādhāra
මූලාරම්භය	Origin
මූලාශ්‍රය	Source
මූලාසනය	Chair
මූලික	fundamental
මූලිකත්වය	Lead
මූලිකයා	Head
මූලිකව	Primarily
මූලිකවම	Basically
මූසල	Gloomy
මූසුවූ	Mūsuvū
මෘත	Dead
මෘතදේහය	Archbold
මෘදු	Soft
මෘදුකාංග	Software
මෘදුකාංගය	Software
මෙගොඩ	Side
මෙච්චර	So
මුවදොර	Face
මුවා	Hiding
මුවාවෙන්	Under the guise
මුවින්	Mouth
මුවෝ	Deer
මුසපත්	Dread
මුස්ලම්	Islamic
මුසාවක්	Lie
මුසුකිරීමට	Mixed
මුසුකොට	Fingertips
මුසුව	Merge
මුසුවක්	Lavendar
මුහුණ	face
මුහුණත්	Interface
මුහුණදෙන	Face
මුහුණපාන	Face
මුහුණලා	Facing
මුහුද	Sea
මුහුදු	Sea
මුහුදුබඩ	Seaside
මුහුදුබත්	Shipwreck
මුහුම්කරණයට	Hybridisation
මුහුම්කරන	Hybridisation
මුළා	Misleading
මුළින්	IPO
මුළු	The entire
මුළුතැන්ගේ	The kitchen
මුළුනින්ම	Muḷuninma
මුළුමනින්	Totally
මුළුමහත්	The entire
මූඛයට	Mūkhayaṭa
මූණු	Faces
මුද්‍රණාලය	the press
මුදාගන්නා	Rescued
මුදාහැරීම	Release
මුදුණ	Hazards
මුදුන	Top
මුදූ	Mudū
මුනුබුරා	Grandson
මුමුණන	Hum
මුර	Password
මුරකරු	Watcher
මුරගල	Focal
මුරණ්ඩු	Stubborn
මුරපදය	password
මුරපොළ	Post
මුරය	Shift
මුල	Early
මුලකුර	Initials
මුලපුරයි	Forges
මුලස්ථාන	Headquarters
මුලසුන	Chair
මුල්	First
මුල්කර	Based
මුල්ගල	Stone
මුල්පිටපත්	Originals
මුල්පෙළ	Leading
මුල්බැස	Rooted
මුල්ම	First
මුල්ල	The corner
මුල්විය	Ultimately
මුලාවක්	A falsehood
මුලින්	First
මුලින්ම	original
මුලිනුපුටා	Elimination
මුලු	Total
මුලේ	The stump
මුව	Deer
මුවට	Mouth
මිල	price
මිලදි	Purchase
මිලයට	Buy
මිලියනය	Million
මිලේච්ඡ	Barbaric
මිශ්‍ර	Mixed
මිශ්‍රණ	Mixtures
මිශ්‍රවීම	The mixing
මිසදිටුවන්	Misadiṭuvan
මිසයිලය	Missile
මිස්	Miss
මිහිකත	Earth
මිහිදන්	Buried
මිහිපිට	Earth
මිහිමත	Earth
මිළ	Prices
මීකිරි	Mixe
මීට	The
මීටර	M
මීදුම	the mist
මීපැණි	Honey
මීමින්නා	Silicone
මීමෙකු	Scapegoats
මීයා	Rat
මීහරකුන්	Buffalo
මීළඟ	The next
මුං	Green
මුංඇට	Gram
මුක්කුව	Prop
මුක්තඛණ්ඩ	Muktakhaṇḍa
මුකුළුව	Mukuḷuva
මුඛය	Mouth
මුඛරි	Vocal
මුට්ටිය	Pot
මුණගැසෙන	Meet
මුණුබුරා	Grandson
මුත්‍රා	Urine
මුතු	Pearl
මුදල්	Cash
මුදලාලි	Mudalali
මුදවාපු	Curdled
මුදවීම	This message
මුද්ද	Ring
මුද්දරය	Stamp
මුද්දරස්පලම්	Muddaraspalam
මුද්‍රණය	Print
මිත්තණිය	Grandmother
මිත්තනිය	Grandmother
මිත්‍ර	Friendship
මිත්‍රත්වය	Friendship
මිත්‍රයා	Friend
මිත්‍රශීලී	Friendly
මිතුදම්	Friendships
මිතුරකු	Friend
මිතුරා	Friend
මිතුරිය	Friend
මිතුරෝ	Friends
මිථ්‍යාදෘෂ්ටික`	Mithyādṛṣṭika`
මිථ්‍යාව	Myth
මිදීම	Release
මිදුල	Courtyard
මිදෙන්න	Win
මින්පසු	Henceforth
මින්පෙර	Previously
මිනිත්තු	minutes
මිනින්දෝරු	Survey
මිනිබිරිය	Granddaughter
මිනිමැරීම	Murder
මිනිය	Measurable
මිනිරන්	Graphite
මිනිස්කම	Humanity
මිනිස්සු	People
මිනිසා	man
මිනිහ	Often teach
මිනිහා	the man
මිනිහෙක්	Man
මිනී	Grave
මිනීමරණ	Murderous
මිනීමරුවෝ	Killers
මිනීමැරුම	Murder
මිම්ම	Measure
මියගියා	Died
මියයාම	Death
මියැදෙන	Dies
මියුරු	Beautiful
මිරිකීම	Squeezed
මිරිඟුවක්	Mirage
මිරිදිය	Freshwater
මිරිස්	Chilli
මැණික්	Gem
මැතිතුමා	Mr.
මැතිනිය	Mrs
මැතිරීම	Incantations
මැතිවරණය	Election
මැතිසබය	Parliament after
මැද	Middle
මැදහත්	Moderately
මැදින්	Through
මැදියම	Midnight
මැදිරිය	Gallery
මැදිවන	Through
මැදිවූ	Hit areas
මැදිහත්වීම	Intervention
මැදීමටත්	Brushing
මැදුර	Madura
මැන්න	Measured
මැනැවින්	Premium
මැනීම	Measurement
මැඳුර	Madura
මැය	Eda
මැයි	May
මැරයෝ	Thugs
මැරවරයින්	Thugs
මැරිලා	Dead
මැරීම	Killing
මැරුණ	Dead
මැරුවා	Killed
මැරෙන	Suicide
මැල	Foliage
මැලවුණු	Withered
මැලියම්	Glue
මැලිවීම	More secure
මැලේසියාව	Malaysia
මැවෙන	Paints
මැෂිම	Machine
මැසි	Bee
මැසිවිලි	Murmuring
මැසීම	Sew
මැහුම්	Sewing
මැළවුණු	Sprouted
මෑණියන්	Mother
මෑත	recent
මෑතදී	Recently
මිට	Earlier
මිටි	Bundles
මිටිය	Hammer
මිටියාවතක	Valley
මිඩංගු	Spend
මිණිකැට	Police officials
මිණිබිරිය	Granddaughter
මායිම	Border
මාර	MR
මාරක	Deadly
මාරයා	Mara
මාර්ගය	road
මාර්ගස්ථ	Transit
මාර්ගෝපදේශකයා	Guide
මාර්තු	March
මාරාන්තික	Deadly
මාරාන්තිකයි Deadly
මාරු	transfer
මාරුකිරීම	Transfer
මාරුතය	Wind
මාරුවීම	Switch
මාලය	Necklace
මාලාව	Series
මාලිගාව	House
මාලු	Fish
මාලුවා	Fish
මාලේ	Male
මාවත	Avenue
මාසය	Month
මාස්ටර්	Master
මාස්පතා	Monthly
මාසික	Month
මාසෙ	Month
මාසේ	Month
මාහැඟි	Fine
මාළිගය	Palace
මාළිගාව	Temple
මාළු	Fish
මාළුවා	Fish
මාළුවෝ	Fish
මැංගුස්	Mangosteen
මැක්කන්	Fleas
මැකී	Mackie
මැකෙනා	Deleted
මැජික්	Magic
මැටි	Clay
මැඩපැවැත්වීමට                          	Preventive
මැඩලීම	Preventing
මැඩියා	Frog
මළ	dead
මළකඩ	Rust
මළකඳ	Corpse
මළගමට	Funeral
මළගිය	Dead
මළදරු	Maḷadaru
මළසිරුර	dead body
මළා	Dead
මළානික	Fading
මළු	Bags
මළුව	Courtyard
මළුවේ	Courtyard
ම්ලේච්ඡ	Brutal
මා	me
මාංචු	Busted
මාංශ	Meat
මාංශපේෂි	Slowness
මාංශමය	Fleshly
මාගේ	My
මාණ්ඩලික	Staff
මාණික්‍ය	Priceless
මාත්‍රයක්	Dim
මාත්‍රාව	Dose
මාතා	Mata
මාතාව	Mother
මාතෘකාව	Topic
මාතෘත්වය	Parenthood
මාදිලියක	Model
මාධ්‍යය	Media
මාධ්‍යවේදියා	Journalist
මානයට	Knocked out
මානවයා	Man
මානසික	Mental
මානසිකත්වය	Mentality
මානුෂික	Humanitarian
මානුෂීය	Humanitarian
මාපකය	Gauge
මාපාංකය	Modulus
මාපිය	Parent
මාපියන්	Parents
මාපියෝ	Lone
මාපිලා	Parents
මාමණ්ඩිය	Grandfather
මාමා	Uncle
මායාකාරියක	Witches
මායාකාරී	Witch
මායාව	Magic
මහණ	Monk
මහත	Fat
මහත්තයා	Mr.
මහත්මා	Mahatma
මහත්මිය	Ms.
මහත්ය	Great
මහත්වරු	Also
මහතා	Mr.
මහන	Sewing
මහන්න	Sew
මහන්සිය	Efforts
මහපාර	Some part of
මහමඟ	The road
මහමැතිවරණය	Parliamentary elections
මහරජ	M'sieu
මහරාජා	Maharaja
මහරැජින	Queen
මහල	Level
මහල්	Apartments
මහල්ලා	Mahalla
මහලු	Elderly
මහළු	Old
මහාචාර්ය	Professor
මහාද්වීපය	The continent
මහාධිකරණය	High
මහාමාර්ග	Highways
මහිමයට	Glory
මහේස්ත්‍රාත්	Magistrate
මහෝත්සව	Function
මහෝපකාරි	Help
මලානිකව	Withering
මලු	Luggage
මලේ	Trinco
මව`	Mava`
මවගේ	Mother
මවන	Created
මව්කිරි	breast milk
මව්පියෝ	Parents
මව්බිම	Motherland
මව්රට	PTI
මව්වරු	Mothers
මවා	Created
මවිතය	Amazement
මවිසින්	As I
මවුකිරි	Breastfeeding
මවුතුමිය	Mavutumiya
මවුපියන්	Parents
මවුබිම	Motherland
මවුරට	Maurus
මවුවරු	Mothers
මසක්	Month
මසන්නා	Dressmaker
මස්	Meat
මස්කඩ	Beef
මස්තිෂ්ක	Cerebral
මස්මාංශවල	Masmāṁśavala
මස්සිනා	brother in law
මසා	Settlement
මසිත	Outward
මසුන්	Fish
මසුරන්	Appreciate it
මසුරු	Parsimonious
මහ	High
මහගු	Thanks
මහගෙදර	The Inspector
මහඟු	Rich
මහචාර්ය	Professor
මහජන	People
මහජනතාව	People
මහජනයා	People
මන්ස්කාන්ත	Manskānta
මනාපය	Preference
මනාලිය	Bride
මනින	Measuring
මනුෂ්‍යයා	Man
මනුස්සකම	Humanity
මනුස්සයා	Man
මනෝ	Psychology
මනෝචිකිත්සක	Psychiatry
මනෝවෛද්‍ය	Psychologi
මයික්‍රපෝනය	Mayikrapōnaya
මයිනා	Mining
මරණය	the death
මරණාසන්න	Death
මරනවා	Kill
මරලා	Kill
මර්දනය	Repression
මර්ධනය	Control
මර්මස්ථාන	Spots
මරා	Killing
මරාදැමීම	Killing
මල	Flower
මලක	Flower
මලකඩ	Rust
මලනුවන්	Malanuvan
මලල	Athletics
මල්	Flower
මල්ලි	Brother
මල්ලී	Brother
මල්වත්ත	Ix
මල්වර	Puberty
මල්සරා	Malsi
මදිවෙලා	Madivelā
මදුරුදැල්	Nets
මදුරුවා	Mosquito
මදුවිත	Booze
මදෙස	Shook
මධ්‍ය	Central
මධ්‍යන්‍ය	The mean
මධ්‍යම	Central
මධ්‍යයේ	Amid
මධ්‍යස්ත	Moderate
මධ්‍යස්ථ	Neutral
මධ්‍යස්ථානය	center
මධ්‍යසාර	Alcohol
මධුර	Madura
මධුසමය	Honeymoon
මනඃකල්පිත	Fantasy
මනදොල	Desires
මනදොළ	Desires
මනමාලි	Bride
මනරම්	Beautiful
මනස	Mind
මනස්ගාත	Spouted
මනසේ	In mind
මනහර	Beautiful
මන්තර	Arts
මන්ත්‍ර	Sorcery
මන්ත්‍රකාරියන්	Sorcerer
මන්ත්‍රීධූරයක්	Member of
මන්ත්‍රීවරයා	Member
මන්ත්‍රීවරු	Members
මන්දගාමී	Slow
මන්දපෝෂණය	Malnutrition
මන්දයත්	Because
මන්දාකිණි	Galaxies
මන්දැයි	Why
මන්දිරය	House
මන්නයා	Manna
මන්සන්දියට	Junction
මඟට	On track
මඟදී	Along the way
මඟපාදා	Man̆gapādā
මඟහරිමින්	Forming
මඟින්	through
මඟුල්	Wedding
මට	to me
මට්ටම	level
මඩ	Mud
මඩුල්ල	Bench
මඩුව	Hall
මණ්ඩපය	Forum
මණ්ඩලය	Board
මතකය	Memory
මතක්වෙනවා	Miss
මතධාරී	Op
මතභේදය	Controversy
මතය	View
මතවාදී	Ideological
මත්	Drugs
මත්කුඩු	Drugs
මත්පැන්	liquor
මත්පැන්හල්	Bars
මත්වූ	Hemophiliac
මත්ස්‍යයාගාර	Matsyayāgāra
මත්ස්‍යා	Fish
මතින්	Over
මතිමතාන්තර	Viewpoints
මතුපිට	Surface
මතුවට	Future
මතුවීම	pop up
මතුවෙනවා	Emerging
මතුවෙලා	Unearthed
මතුසම්බන්ධයි	Matusambandhayi
මද	Slight
මදක්	Slightly
මදනල	Madanala
මදහස	Beaming taxi
මද්‍යසාරය	Alcohol
මදි	Not enough
මදිකම	Lack of
මදිවීම	The slum
මං	I
මංකොල්ල	Robbery
මංකොල්ලකරුවන්ගෙන්	Robbers
මංකොල්ලකෑම්	Robbery
මංගල්ලය	Nanumura
මංගල්‍යය	Feast
මංගලෝත්සව	Reckon
මංජුසා	Vessels
මංමුළා	Missing
මංසන්ධිය	Junction
මංසල	Node
මකන	Deleted
මක්නිසා	For
මකා	Deleted
මකුළුවා	Spider
මග	Way
මගතොටේ	Echo
මගපෙන්වීම	Guidelines
මගහැරී	Diaspora
මගින්	through
මගියා	Passenger
මගී	Passenger
මගීන්	Passengers
මගුල	Hitched
මගුල්	Wedding
මගෙ	My
මගෙන්	from me
මගෙයි	Lockdown
මගේ	my
මගේම	my own
මඟ	Direction
මඟක්	Way
භාරධූර	Bhāradhūra
භාරය	Trust
භාර්යාව	wife
භාව	Expression
භාවනා	Meditation
භාවිතය	use
භාවිතාකරන	use
භාවිතාව	Usage
භාෂා	Languages
භාෂාව	language
භික්ෂුව	Monk
භික්ෂූණී	Bhikkuni
භින්නෝන්මාදයෙන්	Schizophrenia
භීතිය	Fear
භීෂණය	Terror
භුක්තිවිදීම	Eat
භුමිතෙල්	Bhumitel
භුමිය	Site
භූගත	Underground
භූගෝලීය	Geographic
භූතයා	The demon
භූමදානය	Burial
භූමිකාව	Role
භූමිදානය	Burial
භූමිය	Ground
භූවිද්‍යා	Geological
භූවිෂමතා	Topography
භේදය	Split
භෝග	Crop
භෝජන	Dinner
භෝජනය	Meal
භෝජනශාලා	Restaurants
භෝජනාගාර	Restaurants
භෞමික	Terrestrial
බෝවීම	Proliferation
බෝසත්	Bosath
බෞද්ධ	Buddhist
බෞද්ධයා	Buddhists
බෞද්ධයෝ	Buddhists
භංගත්වය	Frustration
භක්තික	Godly
භක්තිය	Devotion
භක්ෂක	Herbivorous
භක්ෂකයා	Jagged
භටයා	Rounder
භටයින්	PERSONNEL
භයංකර	Dramatic
භයානක	Dangerous
භයානකයි   Dangerous
භෂ්ම	Bases
භෂ්මාවශේෂ	The ashes
භ්‍රමණය	Rotation
භාග	Fractions
භාගත	Downloads
භාගය	Half of
භාග්‍ය	Lucky
භාග්‍යසම්පන්න	The proprietor
භාජනය	Subjected
භාණ්ඩ	Goods
භාණ්ඩගාරය	Treasury
භාණ්ඩාගාරය	Treasury
භාණ්ඩාගාරික	Treasurer
භාන්ඩාගාරය	Treasury
භාරකාරත්වය	Custody
භාරකාරයා	Guardian
භාරගනී	Accepts
භාරගනු	Accepted
භාරතීය	BJP
භාරදී	Submitted
භාරදීමට	Delivery
බොක්ක	the Bay
බොජුන්	Gourmet
බොත්තම්	Buttons
බොදු	BBS
බොනවා	Drinks
බොන්න	Drink
බොඳ	Blurred
බොමු	Drink
බොර	Crude
බොරතෙල්	Crude
බොරළු	Gravel
බොරු	FALSE
බොරුකාරයා	Liar
බොරුව	Untruth
බොල්	Bad
බොහොම	Thank you
බොහෝ	so much
බොහෝදෙනා	Many
බොහෝමයකි	There are many
බොහෝය	Many
බොහෝවිට	Often
බොළඳ	Infantile
බෝංචි	Beans
බෝකිරීම	Breeding
බෝගය	Crop
බෝට්ටුව	Boat
බෝඩ්	Bode
බෝඩිම්	Boarding
බෝතලය	Bottle
බෝතල්	Bottle
බෝධිය	Bo
බෝධිවෘක්ෂය	Bōdhivṛkṣaya
බෝධිසත්ව	Bodhisattva
බෝනික්කකු	Dolls
බෝම්බය	Bomb
බෝරිච්චි	Bōricci
බෝලය	Ball
බුල්ඩෝසර්	Bulldozers
බුහුමන්	Honors
බුෆේ	Buffet
බූරු	Colt
බූරුවන්	Donkeys
බෙටි	Betty
බෙදලා	Divided
බෙදාදීම	Distribution
බෙදාහැරීම	Distribution
බෙදීම	Delivery
බෙදුම්වාදය	Separatism
බෙදුවා	Divided
බෙදෙන	Divided
බෙනය	Burrow
බෙර	Drums
බෙලහීන	Depleted
බෙල්ල	Neck
බෙල්ලන්	Oyster
බෙල්ලේ	Neck
බෙලි	Beli
බෙලෙක්	Tin
බෙහෙත්	Drugs
බෙහෙවින්	Much
බේකරි	Bakery
බේද	Differences
බේබදු	Drunkenness
බේරාගැනීම	Save
බේරාගෙන	Save
බේරීම	Survive
බේරුණ	Saved
බේරෙන	Survivors
බේරෙයි	Not die
බේරේ	Beira
බිලියන	billion
බිලොක්	Tweaks
බිසව	QUEEN
බිස්කට්	Biscuits
බිස්නස්	Business
බිහිකිරීම	Producing
බිහිරි	Deaf
බිහිවන	Generated
බිහිවීම	Formation
බිහිවුණා	Formed
බිහිවෙලා	All products
බිහිසුණු	Horror
බිළිඳා	Baby
බිළිඳෙකු	Baby
බීජ	seed
බීජය	Seed
බීට්	Stir
බීම	Beverages
බීමත්ව	Drunk
බීර	Beer
බීලා	Drunk
බුක්තිවිඳීම	And tolerance
බුද්ධාගම	Buddhism
බුද්ධිමත්	Intelligent
බුද්ධිය	Intelligence
බුදිති	The ox
බුදුදුහම	Bududuhama
බුදුපිළිම	Buddha
බුදුමැදුර	Shrine
බුදුරජාණන්වහන්සේ	Buddha
බුදුවීම	Enlightenment
බුබුළු	Lights
බුම්මා	Her reaction
බුමුතුරුණු	Carpets
බුර	Inferno
බුරා	Yobs
බුරුල්	Loose
බුලත්	Betel
බිතුසිතුවම්	Paintings
බිනර	Binara
බින්දු	Drops
බිඳක්	FACTS
බිඳහෙළමින්	Takers
බිඳු	Drop
බිඳුණු	Broken
බිඳුවක්	Drop
බිඳෙන	Fragile
බිබිලි	Itchy
බිම	on the floor
බිමකින්	Ancient
බිමට	Down
බිම්	Ground
බිම්කඩ	Ground
බිම්බෝම්බ	Cleared
බිම්මල්	Mushroom
බිය	fear
බියකරු	Frightening
බියගැන්වීම්	Intimidation
බියගුල්ලෙකු	Coward
බියගුලුකමින්	Cowardice
බියගෙන	Maneuvers
බියට	Fears
බියපත්	Fear
බියර්	Beer
බියවැද්දීම	Intimidation
බියවීම	Fear
බියසැක	Barefaced
බියසුල්ලෙකු	Coward
බිරිඳ	Wife
බිරිය	Wife
බිල	the bill
බිල්	Bill
බිල්ඩින්	Building
බිල්ඩිම	Building
බිල්පත	Bill
බිල්පත්	Bill
බිල්ලට	Scape
බැනියම	Jersey
බැඳීම	Relationship
බැඳුනු	Joined
බැඳුම	Tie
බැම්ම	Wall
බැමි	Wall
බැර	Credit
බැරෑරුම්	Serious
බැරිවුණා	Could not
බැරී	Barry
බැලන්ස්	Balanced
බැල්ම	Look
බැලීම	View
බැලුම්	Balloon
බැලුවා	Looked
බැලූ	Looked
බැවින්ය	Because
බැස	Down
බැස්සා	Down
බැසීම	The descent
බැහැ	Can not
බැහැර	Out
බැහැරවීම	Leaving
බැහැලා	Down
බෑගය	Bag
බෑග්	Bags
බෑණා	son in law
බෑය	Cloaks
බෑවා	Rough landing
බෑවුම	Ramp
බිංදු	Drops
බිංදුව	Zero
බිත්තර	the eggs
බිත්ති	Wall
බිත්තිය	the wall
බ්‍රේක්	Breakaway
බාග	Half
බාධක	Barrier
බාධා	Obstacles
බාධාකාරී	Restrictive
බාබක්‍යු	Bābakyu
බාම්	Bam
බාරකරු	Barak
බාරදෙන්න	Delivery
බාර්ලි	Barley
බාල	Younger
බාල්දි	Buckets
බාල්දු	Downgrade
බාලිකා	Girls
බාලිකාවන්	Girls
බාහිර	External
බැංකුව	Bank
බැක්ටීරියා	Bacteria
බැකෝ	Backhoe
බැගෑපත්ව	Entreated
බැගින්	Each
බැටරි	Battery
බැටළුවා	Sheep
බැටළුවෝ	Sheep
බැට්	Batty
බැණ	Filth
බැතිමතුන්	Devotees
බැදලා	Married
බැදුම	Joined
බැනර	Banners
බැනර්	Banners
බැනල	A piece of
බැන්දා	Tied
බලාත්මක	Enforcement
බලාපොරෝත්තු	Hopes
බලුකුක්කා	Balukukkā
බලූ	Balu
බලෙන්	Force
බව	That
බස	Language
බසය	Bus
බස්	Buses
බස්නාහිර	Western
බස්නැවතුම්	Bus
බස්නැවතුමේ	Viral
බස්රථ	Buses
බස්රිය	The bus
බස්සනවා	Will thrust
බස්සලා	Dipped
බස්සා	Owl
බසියි	Fest
බහක්	Implying
බහිනවා	Down
බහින්න	Down
බහින්බස්වීම්	Heated
බහුජාතික	Multinational
බහුතරය	Majority
බහුලව	Common
බහුවරණ	multiple choice
බහුශ්‍රැත	Prolific
බළකාය	Force
බළලා	Cat
බ්ලූ	Blue
බ්ලොක්	BLOCKS
බ්ලොක්ගල්	Block
බ්‍රහස්පතින්දා	Thursday
බ්‍රහස්පතී	Jupiter
බ්‍රැන්ඩි	Brandy
බ්‍රිගේඩියර්	Brigadier
බලතල	Powers
බලධාරින්	Authorities
බලධාරියා	Authority
බලධාරීන්	Authorities
බලන	View
බලනකල	Casual
බලනකොට	Looking
බලනවා	Look
බලනවිට	Viewing
බලනවිටනම්	Balanaviṭanam
බලන්	Waiting for
බලන්කම්	View
බලන්ගොඩ	Balangoda
බලන්ට	Look
බලන්ඩ	Absolutely
බලන්න	see
බලපත්‍ර	Licensed
බලපත්‍රය	license
බලපත්‍රලාභියා	Licensee
බලපැවැත්වෙන	Effective
බලපෑම	Impact
බලපෑම්	Effects
බලපෑවා	Affected
බලපුළුවන්කාරකම	CILTSL
බලමු	Let's
බලමුළු	Mobilized
බලය	Power
බලයි	Looks
බලලා	Look
බලවත්තු	Powers
බලවතා	Power
බලවතෙක්	Power
බලවේගය	Force
බලශක්තිය	Energy
බලසම්පන්න	Powerful
බලහත්කාරකම්	Violence
බලහත්කාරයෙන්	Forcibly
බල්බය	Bulb
බල්ලා	Dog
බල්ලෙක්	a dog
බල්ලෝ	Dogs
බලාකොටුවට	Balākoṭuvaṭa
බලාගත්තා	Cared
බලාගන්න	Take care
බලාගාර	Power
බලාගෙන	Watching
බඳුන	Jar
බඳුන්	Containers
බඳුය	The unbelievers
බබලන	Bright
බබළන	Shining
බබළයි	Shines
බබා	Baby
බබාලා	Baby
බබෙකු	Baby
බඹරු	Storylines
බයගුළුයි	Bayaguḷuyi
බයයි	Scared
බයවෙලා	Terrified
බයිලා	Baila
බයිසිකලය	Bicycle
බයිසිකලේ	Bike
බර	Weight
බරපතල	Serious
බරපතළ	Serious
බරපැන	Overhead
බරයි	Heavy
බරවා	Filariasis
බරවැඩ	Baravæḍa
බරවැඩි	Baravæḍi
බරවුණු	Baravuṇu
බර්ගර්	Burgers
බරින්	Weight
බලඇණි	Battalion
බලකරනවා	Demand
බලකරන්න	Force
බලකාය	Corps
බලකිරීම	Press
බලකොටු	Strongholds
බලකොටුව	Fortress
බලගතු	Powerful
බලත	Balata
බටු	Brinjal
බඩ	Stomach
බඩඉරිඟු	sweet corn
බඩගින්න	Hunger
බඩගිනි	Hungry
බඩජාරි	Parlance
බඩවැල්	Intestines
බඩු	Items
බඩුමිල	Prices
බඩුමුට්ටු	Furnished
බණ	Bana
බත	Rice
බතල	sweet potato
බත්	Rice
බතික්	Batik
බද්ද	Tax
බද්ධ	Transplant
බද්ධවූ	Constipation
බදා	Wed
බදාගන්නා	Hug
බදාදා	Wednesday
බදාම	Plaster
බදු	Tax
බධාවකි	Sea-
බන්ධනය	Bonds
බන්ධනාගාරගතව	Jail
බන්ධනාගාරය              	Prison
බනින	Blame
බනිස්	Buns
බඳවාගෙන	Recruited
බඳිනවා	Must've
බඳී	Of evidence
බඳු	Like
පෝය	Poya
පෝර	Manure
පෝරකයට	Sentenced
පෝරුව	Board
පෝලිම	Line
පෝලිම්	Queues
පෝෂක	Nutrients
පෝෂණය	Feed
පෝෂනීය	Nutrition
පෝෂ්‍යදායක	Nutritious
පෝෂ්‍යදායී	Nutritious
පෝෂ්‍යපදාර්ථ	Nutrients
පෝෂිත	Sufficient
පෝසත්	Rich
පෝසත්කම	Pōsatkama
පෝස්ටර්	Posters
පෞඪ	Rich
පෞඪත්වය	Pauḍhatvaya
පෞද්ගලික	Private
පෞද්ගලිකත්වය	Personality
පෞද්ගලිකරණය	Privatization
පෞද්ගලීකරණය	Personalization
පෞරාණික	Ancient
පෞරුෂත්වය	Personality
පෞරුෂය	Personality
ඵලකයක	Plaque
ඵලදායී	Effective
ඵලදායීතාව	Productivity
ඵලදායීතාවයක්	Productivity
ඵලදාව	Yields
ඵලය	Fruit
ඵලවිපාක	Consequences
බංකර	Bunkers
බංකු	Benches
බකට්	Buckets
බක්කි	Shops
බක්මහ	New Year
බක්මාසය	New Year
බටනලා	Flute
බටය	Pipe
බටයක්	Straw
බටර්	Butter
බටහිරකරණයක්	Baṭahirakaraṇayak
බටහිරට	West
පොලව	Ground
පොල්	Coconut
පොල්අතු	Thatched
පොල්කිච්චා	Magpies
පොල්කිරි	Coconut Milk
පොල්ල	Pole
පොල්වතු	Coconut
පොලියට	Payday
පොලිස්පති	IGP
පොලිසිය	the police
පොලී	Interest
පොලීස්	Police
පොලීසිය	police
පොලු	Poles
පොලෙන්	Dropping
පොලේ	Market
පොලොව	Ground
පොසිලය	Fossilized
පොහොට්ටුව	bud
පොහොය	Poya
පොහොර	fertilizer
පොහොසතෙකු	Rich
පොළ	Market
පොළඟා	Vipers
පොළඹවා	Entice
පොළව	Underground
පොළිතින්	Poḷitin
පොළෙන්	Market
පොළෙහි	Pola
පොළේ	Exchange
පොළොව	Earth
පොළොවේ	Earth
පෝතකයා	Scout
පෝනි	Pony
පේළි	Row
පේළිය	Line
පොකිරිස්සා	crayfish
පොකුණ	Pond
පොකුරු	Cluster
කියවනවා    reading
කියෙව්වා     read
පොඟවලා	Moisten
පොට	Thread
පොඩ්ඩක්	little
පොඩි	Small
පොඩිත්තා	Poḍittā
පොඩිවන	Small
පොත	book
පොත්	Books
පොත්ත	Bark
පොතු	Bark
පොතේ	Book
පොද	Drizzle
පොදයක්	Podayak
පොදුයි	common
පොම්පය	Pump
පොරකෑම	Scramble
පොරකෑමක්	Scramble
පොරණ	Poraṇa
පොරපිටිය	Arena
පොරබදන	Struggling
පොරවාගෙන	Wearing
පොරි	Popcorn
පොරොන්දුව	promise
පොරොව	Axe
පොල	Market
පොලක්	Market
පෙනෙයි	See
පෙඳය	Eared
පෙබරවාරි	February
පෙම්	Love
පෙම්වතා	Boyfriend
පෙම්වතිය	Girlfriend
පෙම්වතුන්	Lovers
පෙරදිග	East
පෙරදින	Previous
පෙරමුණ	Front
පෙරලුණා	Overturn
පෙරවරු	At
පෙරහැර	Procession
පෙරහුරුව	Rehearsal
පෙරළා	Return
පෙරළිකාරයකු	Peraḷikārayaku
පෙරළිය	Changes in
පෙරළීම	Overturning
පෙරුණ	Perum
පෙරෙට්ටුවක	Pereṭṭuvaka
පෙරේත	Veneration
පෙරේදා	the day before yesterday
පෙව්වා	Access
පෙවිලි	Stripping
පෙවීම	Intrusion
පෙළගැස්ම	Map
පෙළපතට	Family Tree
පෙළපාලිය	Parade
පෙළපාළි	Parades
පෙළඹීම	Tsien
පෙළඹෙනවා	Tend to
පේනවා	See
පේන්න	See
පේර	Guava
පේලි	Row
පේශීන්	Muscles
පූර්වාදර්ශය	Precedent
පූරාම	Throughout
පූස්	Kitten
පූසෙක්	a cat
පෘතුගීසීන්	Portuguese
පෘතුවිය	Earth
පෘථිවියේ	Earth
පෘෂ්ඨය	Surface
පෘෂ්ඨිමත්	Pṛṣṭhimat
පෙඟුණ	Overenthusiastic
පෙට්ටගමක	Peṭṭagamaka
පෙට්ටිය	Ark
පෙට්‍රල්	Petrol
පෙට්‍රෝල්	Petrol
පෙත්සම	Petition
පෙත්සම්	Petitions
පෙත්සම්කරු	Petitioner
පෙති	Slices
පෙදරේරු	Masonry
පෙදරේරුවෙක්	Carpenter
පෙදෙසේ	Place
පෙනය	Penaya
පෙනහලු	Lungs
පෙනහළු	Lung
පෙන්නන	SHOW
පෙන්වාදීමට	Spot
පෙන්වීම	Showing
පෙනීම	Sight
පෙනුණා	It seemed
පෙනුම	the appearance
පෙනෙනවා	See
පුරප්පාඩු	Vacancies
පුරවරය	City
පුරවා	Fill
පුරවැසියන්	Citizens
පුර්ණ	Full
පුරාණ	ancient
පුරාවිද්‍යාව	Archeology
පුරාවෘත්ත	Myths
පුරුදු	Habits
පුරුෂයා	Husband
පුරුෂාධිපත්‍යය	Puruṣādhipatyaya
පුරෝකතනය	Forecast
පුරෝගාමීන්	Pioneers
පුලුල්	Extensive
පුලුවන්	Can
පුවත්	news
පුවත්පත්වේදී	Newspapers
පුවරුව	Keyboard
පුස්	Moulds
පුස්තකාලය	Library
පුස්තකාලයාධිපති	Librarians
පුහුණුකරු	Coach
පුහුණුව	training
පුහුණුවීම්	Training
පුහුල්	Puhulwella
පුළිගු	Spark
පුළුල්	Expansion
පුළුවන්	could
පුළුස්සා	Burned
පූජකවරු	Priests
පූජනීය	Sacred
පූජාව	Offering
පූපුරා	Pūpurā
පූර්ණ	Full
පූර්ව	Pre
පුත්‍රයා	Son
පුතාට	Son
පුතු	Son
පුතෙක්	Son
පුතෙකි	A son
පුදබිම	Sacred
පුද්ගලයා	the person
පුද්ගලයෙකු	a person
පුද්ගලික	Personal
පුද්ගලිකත්වය	Privacy
පුද්ගලීකරණයට	Privatization
පුද්ලයෙක්	Shrug
පුදුමයි	Amazing
පුදුමසහගත	Wonderful
පුදුමාකාර	Amazing
පුනර්ජනනීය	Renewable
පුනර්ජීවන	Revival
පුනරීක්ෂණය	Review
පුනරුත්ථාපනය	Rehabilitation
පුන්‍ය	Charity
පුනීලයක්	Droop
පුනුරුත්ථාපනය	Rehabilitated
පුපුරා	Exploded
පුපුරායාම	Explosion
පුපුරායාමෙන්	Explosion
පුපුරු	Sparks
පුපුරුවා	Exploded
පුම්බලා	Stuffing
පුම්බා	Inflated
පුමුඛ	Premier
පුර	Pura
පුරද්දකි	Puraddaki
පුරන	Sign in
පුරන්	Fallow
පුරන්ව	Fallow
පුරපති	Mayor
පුරපසළොස්වක්	Purapasaḷosvak
පිළිතුරු	Answers
පිළිපැදීම	Follow
පිළිබඳ	about
පිළිබිඹුවන	Reflective
පිළිමය	Statue
පිළිඹිබු	Reflects
පිළියම	Cure
පිළියෙල	Preparation
පිළිරුව	Statue
පිළිවෙත	Policy
පිළිවෙළ	Order
පිළිවෙළට	Order
පිළිසකර	Recycle
පිළිසඳර	Chat
පිළිසරණ	Rescue
පිළිස්සීම	Bake
පිළිස්සෙන	Burning
පිළිහුඩුවා	Kingfisher
පීඨය	Faculty
පීඩනය	Pressure
පීඩාව	Tribulation
පීඩාවලට	Persecution
පීදීම	Panicles
පීනන්න	Swim
පීරා	Combed
පීල්ලකට	Oncoming
පීසා	Pizza
පුංචි	Small
පුංචිම	Smallest
පුටු	Chairs
පුටුව	Chair
පුටුවකින්	Chair
පුටුවේ	Chair
පුණ්‍යකර්මය	Noble cause
පුණ්‍යවන්ත	Artefacts
පිවිසෙයි	Enters
පිෂ්ටමය	Starch
පිෂ්ටය	Starch
පිසදාති	Pisadāti
පිස්ටනය	Piston
පිස්තෝලය	Pistol
පිස්තෝලයක්	Pistol
පිස්සියක්	Crazy
පිස්සු	Crazy
පිස්සුව	Madness
පිසීම	Cooking
පිසෙන	Arrival
පිහාටු	Feathers
පිහාටුවල	Feathers
පිහි	Knives
පිහිට	Help
පිහිටි	In
පිහිටීම	Location
පිහිටුවීම	Establishment
පිහිදා	Swimming
පිහිනන්නෝ	Pihinannō
පිහිනීම	Swimming
පිහිනුම්	Swimming
පිහිය	The knife
පිළ	Colla
පිළවෙල	Piḷavela
පිළිකන්න	Sweep
පිළිකා	Cancer
පිළිකාව	Cancer
පිළිකාවලට	Cancer
පිළිකුල්	Disgusting
පිළිගත්තා	Accepted
පිළිගන්වා	Believe that
පිළිගනී	Admits
පිළිගැන්වීමට	Offering
පිළිගැනිණ	Acceptable
පිළිගෙන	Accepted
පිළිතුර	Answer
පිරවීම	Filling
පිරික්සීම	Check
පිරිනැමීම	Offer
පිරිපහදු	Refinery
පිරිපුන්	Pursuing
පිරිමසා	Meet
පිරිමැද්දා	Pirimæddā
පිරිමැසීම	Efficient
පිරිමි	Men
පිරිමියා	Man
පිරිමියෙක්	Man
පිරිලා	Full
පිරිවරාගෙන	Gathering
පිරිවැය	Cost
පිරිස්	Personnel
පිරිසිදු	Cleaning
පිරිසිදුකම	Cleanliness
පිරිහීම	Decline
පිරිහුණා	Grout
පිරෙනවා	Welling
පිරෙයි	FILL
පිරෙව්වා	Filled
පිරේ	Signing into
පිල්	Phil
පිලිකා	Cancer
පිලිගන්නා	Acknowledging
පිලිබඳව	About
පිලියම්	Address
පිලිස්සීම	The burning
පිලිස්සුණු	Burnt
පිලිස්සුම්	Burns
පිලිහුඩුවා	Pilihuḍuvā
පිලේ	Team
පිවිතුරු	Clean
පිවිසුම	Entrance
පිපිරුම	Bang
පිපිලා	Nice
පිපුණු	Sourdough
පිපුරුම්	Bang
පිපෙන	Bloom
පිබිදෙන	Awakening
පිම්බේය	Blew
පිම්ම	Leap
පිඹුරා	Python
පිඹුරුපත්	Plans
පිය	Father
පියකරු	Beautiful
පියකු	Father
පියගැටපෙළ	Stairways
පියතුමා	Fr.
පියන	The cap
පියන්	Lid
පියඹන	Flying
පියඹා	Fly
පියයුරු	Breast
පියරු	Powder puff
පියවර`	Piyavara`
පියවි	Naked
පියවීම	Settlement
පියස	Piyasa
පියා	Father
පියාගේ	Father
පියාණන්	Father
පියානෝව	the piano
පියාපත්	Wings
පියාඹන්න	Fly
පියාසර	Fly
පියෙකු	Father
පිරමිඩාකාර	Pyramidal
පිරමීඩ්	Pyramid
පිට්ටනිය	Ground
පිට්ටු	Pittu
පිට්සා	Pizza
පිටාර	Exhaust
පිටාරගලන	Piṭāragalana
පිටි	Flour
පිටිකිරි	Milk
පිටිය	Ground
පිටිවහලක්	Help
පිටිසර	Isolated
පිටුදැකීම	Elimination
පිටුපසින්	from behind
පිටුපා	Backs
පිටුව	Page
පිටුවහල්	Deported
පිඩැලි	Sod
පිණි	Frost
පිණිස	To
පිණිසයි	Might
පිණුම්	Tops
පිඬක්	Clay
පිත්ත	Stick
පිත්තල	Brass
පිති	Sticks
පිතිකරු	Batsman
පිතිකරුවෙකු	Batsman
පිදීම	Eminent citizens
පිදුරු	Hay
පිනක්	Good deed
පිනවා	Feast
පිනවීමට	-unsuspecting
පින්තාරු	Painting
පින්තූරය	Picture
පින්සල්	Brush
පිනි	Dew
පිනිබිඳු	Dewdrops
පිනුම්	Flyback
පිපාසය	Thirst
පිපාසයෙන්	Thirsty
පිපාසිත	Thirsty
පිපිරීම	Explosion
පැහැදිළිව	Clearly
පැහැදී	Ready
පැහැදීමක්	Impressed
පැහැය	Color
පැහැරගෙන	Kidnapping
පැහැරගෙනයාම	Abduction
පැළකිරීමට	Pæḷakirīmaṭa
පැළඳවීමේ	Clothing
පැළඳීම	Wear
පැළඳුම්	Clothing
පැළය	Plant
පැළැන්තියේ	Rap
පැළැඳීම	Toiletries
පැළැඳුම්	Toiletries
පැළෑටි	Herbs
පෑගීම	Walking
පෑදෙනවා	Present themselves
පෑන	Pen
පෑන්	Pan
පෑම	Claim
පෑවිල්ලේ	Pǣvillē
පෑවේය	Abrasively
පිං	Ping
පිංකම	Pooja
පිංතූර	Images
පිඟාන	The dish
පිච්චෙන	Hot?
පිච්චෙයි	The judgment
පිටකිරීම	Emissions;
පිටට	Out
පිටතදී	OUTSIDE
පිටත්වීම	Departures
පිටත්වේ	Leaves
පිටතින්	The outside
පිටපත	version
පිටපතක්	copy
පිටරට	Abroad
පිටරටින්	Foreigners
පිටවුණා	Leaked
පිටවෙයි	Leaves
පිටසකවලින්	Piṭasakavalin
පිටස්තර	Outsiders
පැලැන්තිය	Elite
පැලෑටිය	Plant
පැලීම	Bursting
පැලෙන	Distraught
පැලේ	Sapling
පැවතුම්	Duration
පැවරීම	Transferring
පැවරුම්	Assignments
පැවරෙනවා	Upon
පැවසුවා	Told
පැවසුවේය	Said:
පැවසෙන	Supposed
පැවැත්ම	Survival
පැවැත්වීම	Conduct
පැවැත්වෙනවා	Held
පැවැතීම	Depressed
පැවැරීම	Hayles
පැවැසීම	Kumarathunga told
පැවැසුවා	, Told
පැවැසුවාය	Pævæsuvāya
පැවැසුවේය	Said
පැවිදි	Ordained
පැවිදිව	Ordained
පැෂන්	Passion
පැසවා	No limits,
පැසසුම්	Recognitions
පැස්ටල්	Pastel
පැස්බරා	Ostrich
පැසි	Basketball
පැසිපන්දු	Basketball
පැසී	White
පැසීම	Gray
පැහැ	Accent
පැහැගත්	Dashboard
පැහැති  	Color
පැහැදිලියි	Clearly
පැහැදිලිවම	Clearly
පැමිණිලිකරු	Prosecutor
පැමිනීමේ	Attendance
පැමිනෙයි	Comeback
පැය	hour
පැයක්	an hour
පැයෙන්	Hour
පැයේ	Hour
පැරණි	old
පැරණිතම	Oldest
පැරණියි	Old
පැරදවීම	Beating
පැරදී	Lost
පැරදුණ	To defeat
පැරදුණු	Defeated
පැරසිටමෝල්	Paracetamol
පැරැන්ණෝ	Pærænṇō
පැලවීම	Chalets
පැල්	PAL
පැල්පත්	Shanties
පැල්ලම්	Stains
පැටියෙකු	Its
පැටිස්	Patties
පැණ	FAQs
පැණි	Honey
පැණිරස	Sweets
පැතලි	Flat
පැත්ත	Side
පැත්තක්	Sides
පැති	Side
පැතිකඩ	View
පැතිරීයාම	Outbreak
පැතිරෙන	Spreading
පැතිරෙයි	Spreads
පැතුම	Wish
පැතුවෙමි	It back
පැදවීම	Driving
පැදි	Equipment
පැදිය	Motorcycles
පැදීම	Riding
පැදුර	Bed
පැදුරු	Mats
පැනනැඟුණේ	Irreverent
පැනපු	Culling
පැනය	Question
පැනයක්	Question
පැනයාමට	Getaway
පැන්ට්‍රිය	Pantry
පැන්නේය	Moved out
පැන්සලක්	Pencil
පැන්සල්	Pencils
පැනි	Honey
පැනීම	Jump
පැනීමට	Jump
පැනීම්	Clouds
පැමිණියා	Came
පැමිණිල්ල	Complaint
පැමිණිල්ලක්	Complaint
පැමිණිලි	complaints
පාවුළු	Paul
පාවෙන	Floating
පාවෙන්නේ	Cools to
පාෂාණ	Rock
පාසල	School
පාසල්	schools
පාසලෙන්	School
පාසලේ	School
පාස්	Paz
පාස්කු	Easter
පාසැල	School
පාසැලක	School
පාසැල්	school
පාසැල්වල	Schools
පාසැලේ	School
පාසි	Moss
පාහොර	Pāhora
පාළනය	Adapting
පාළම	Bridge
පාළුයි	Miss
පාළුව	Formless
පාළුවෙන්	Lonely
පැකට්	Packets
පැකැට්ටුවල	Emblazoned
පැකිලීමක්	Openly
පැකේජයක්	Package
පැඟිරි	Citrus
පැටලීම	Saga
පැටලෙන	Involving
පැටව්	Young
පැටවීම	Loading
පැටවුන්	Baby
පැටවූ	Loaded
පැටවෙකු	Baby
පැටළුණු	Mess
පැටියා	Baby
පාරාදීසය	Paradise
පාරිභෝගික	Customer
පාරිභෝගිකයෝ	Customers
පාරිභෝගියාට	Customer
පාරිභෝජනය	Consumption
පාරිලිමේන්තුවට	Parliment
පාරිශුද්ධ	Pure
පාරිශූද්ධ	Pāriśūddha
පාරිසරික	Environment
පාරුව	Ferry
පාරුවේ	Ferry
පාරේ`	Pārē`
පාරේදී	Road
පාලකයා	the ruler
පාලකයෝ	Rulers
පාලන	Administration
පාලනය	control
පාලනයවන	And coming
පාලනාධිකාරිය	Administration
පාලනාධිපති	Administration
පාලම	Bridge
පාලම්	bridges
පාලම්පාරුවට	Ferry
පාලිකාව	Matron
පාලු	Ghost
පාලුවීම	Miss
පාවහන්	footwear
පාවා	Betrayed
පාවාඩ	Nakedly
පාවාදීම	Betrayal
පාවාදීමක්	Betrayal
පාවිච්චිකරන්නේ	Been used
පාවිච්චිය	Usage
පාවී	Floated
පාදමට	Base
පාදය	Leg
පාදයේ	The foot
පානය	Drink
පානයට	Drinking
පාන්	Bread
පාන්තික	Class
පාන්දර	Early
පානිය	Drinking
පානීය	drinking
පාප	Sin
පාපන්දු	Football
පාපන්දුව	soccer ball
පාපය	Sin
පාපයන්	Sins
පාප්තුමා	Pope
පාප්ප	Paste
පාපැදි	Cycling
පාපැදියක්	A bicycle
පාපෝච්චාරණය	Confessions
පාමුල	At the foot
පායයි	Breaks
පායලා	Is up
පාර	Road
පාරක්	Road
පාරජම්බුල	Ultraviolet
පාරට	The streets
පාරදෘශ්‍ය	Transparent
පාරදෘෂ්‍ය	Transparent
පාරම්පරික	Traditional
පාරවල්	Roads
පාර්ලිමේන්තුව	Parliament
පාර්ශවය	Party
පාර්ශවයන්ටද	Pārśavayanṭada
පාර්ශවයෙන්	Part
පාර්ශ්වීක	Pārśvīka
පාර්සලය	Package
පාර්සල්	Parcels
පාර්සලේ	Package
පාක්	Park
පාක්ෂිකයා	Supporters
පාක්ෂිකයෝ	Supporters
පාගමනට	March
පාචනය	Diarrhea
පාට	Color
පාටක	Color
පාටක්	Color
පාටට	Color
පාටය	Border
පාටි	Party
පාටියක්	Party
පාඨකයා	Reader
පාඨකයින්ට	Readers
පාඨමාලාව	Course
පාඨමාලාවන්	Courses
පාඨය	Motto
පාඨශාලා	College
පාඨශාලීය	School
පාඨාංක	Readings
පාඩම	Lesson
පාඩම්	lessons
පාඩුව	Loss
පාඩුවේ	Quietly
පාත්තරය	The begging bowl
පාත්තිවලට	Beds
පාත්වුණා	Pātvuṇā
පාත්වෙලා	Pātvelā
පාත්‍ර	Bowls
පාත්‍රවූ	Respected
පාත්‍රවෙන	Won
පාතාල	Underworld
පාතාලය	Hell
පාතාලයේ	Hell
පාතාලේ	Hell
පාද	EN
පාදක	Based
පාදඩ	Diseased
ප්‍රාණ	Hostage
ප්‍රාණවත්	Saturate
ප්‍රාණියෙකි	Prāṇiyeki
ප්‍රාතිහාර්ය	Miracles
ප්‍රාතිහාර්යයක්	Miracle
ප්‍රාථමික	Primary
ප්‍රාදේශීක	Pradeshiya
ප්‍රායෝගික	Practical
ප්‍රාර්ථනයන්	The hope
ප්‍රාර්ථනා	Hope
ප්‍රින්ටරය	Printer
ප්‍රියකරන	Is loved
ප්‍රියජනක	Interest
ප්‍රියතම	Favorite
ප්‍රියමනාප	Pleasant
ප්‍රිස්මය	Prism
ප්‍රීති	Rejoice
ප්‍රීතිමත්	Good
ප්‍රීතිය	Joy
ප්‍රීතියට	Happiness
ප්‍රීතියෙන්	Joy
ප්‍රුදගලයෙකු	Prudagalayeku
ප්‍රුමුඛ	Prumukha
ප්‍රෙෂර්	Pressure
ප්‍රේක්ෂක	Audience
ප්‍රේක්ෂකයාට	Audience
ප්‍රේක්ෂකාගාරයක්	Audiences
ප්‍රේමකතා	Prēmakatā
ප්‍රේමය	Love
ප්‍රේමියා	Love
ප්‍රෝටීන	Protein
ප්‍රෝටීන්	Protein
ප්‍රෝටෝන	Protons
ප්‍රෝඩාවක්	Fraud
ප්‍රෝන්	Shooter
ප්‍රෞඩ	Heritage
ප්‍රෞඩත්වය	Pride
ප්‍රසන්න	Prasanna
ප්‍රසව	Obstetrician
ප්‍රසවයේ	Obstetric
ප්‍රස්තාරය	Graph
ප්‍රස්තූතය	Premises
ප්‍රස්ථාරය	Graph
ප්‍රසාදය	Welcomes
ප්‍රසාරණය	Expansion
ප්‍රසිද්ධ	Known
ප්‍රසිද්ධයි	Known
ප්‍රසිද්ධව	Known
ප්‍රසිද්ධිය	Popularity
ප්‍රසිද්ධියේ	in public
ප්‍රසූත	Birth
ප්‍රසූතිකාල	Labour
ප්‍රසූතිය	Delivery
ප්‍රසූතියට	Delivery
ප්‍රසූතියෙන්	Childbirth
ප්‍රසූතියේ	Birth
ප්‍රහසනය	Humor
ප්‍රහාරකයා	Attacker
ප්‍රහාරය	attack
ප්‍රහාරයේදි	Prahārayēdi
ප්‍රහේලිකාව	Puzzle
ප්‍රහේළිකාව	The puzzle
ප්‍රාකාරය	Wall
ප්‍රාග්	Prague
ප්‍රාග්ධනය	capital
ප්‍රාගුණ්‍යය	Fullest
ප්‍රාචීන	Oriental
ප්‍රාඥායකු	Wise men
ප්‍රාඥාවන්තයෙකු	Prāgnāvantayeku
ප්‍රාඩෝ	Prado
ප්‍රවණතාව	Trend
ප්‍රවනතාව	Trend
ප්‍රවර්ධන	Promotion
ප්‍රවාහන	of Transport
ප්‍රවාහනය	Transport
ප්‍රවාහයට	Flow
ප්‍රවීන	Veteran
ප්‍රවෘත්ති	News
ප්‍රවෘත්තිය	News
ප්‍රවේග	Velocity
ප්‍රවේගය	Velocity
ප්‍රවේශපත්	Tickets
ප්‍රවේශය	access to
ප්‍රවේසම්	Cautious
ප්‍රවේසමෙන්	Carefully
ප්‍රශංසනීය	Praiseworthy
ප්‍රශංසනීයයි	Commendable
ප්‍රශංසා	Praise
ප්‍රශංසාව	Praise
ප්‍රශස්ත	Optimum
ප්‍රශ්න	questions
ප්‍රශ්නයක්	a problem
ප්‍රශ්නවලට	Questions
ප්‍රශ්නවලදී	Issues
ප්‍රශ්නාර්ථ	Question
ප්‍රශ්නාර්ථයක්	Questions
ප්‍රශ්නාවලියක	Quiz
ප්‍රශ්නේ	The problem
ප්‍රශ්වාස	Breathing
ප්‍රසංගය	Concert
ප්‍රසංගයේ	Concert
ප්‍රසංසනීයයි	Prasaṁsanīyayi
ප්‍රසංසා	Praise
ප්‍රසන්ටේෂන්	Presentation
ප්‍රධානී	Head
ප්‍රධානීන්	Heads
ප්‍රනීත	Delicious
ප්‍රපාතය	Cliff
ප්‍රබන්ධ	Fiction
ප්‍රබල	Strong
ප්‍රබලයා	Powerful
ප්‍රබෝධමත්	Inspirational
ප්‍රබෝධය	Refreshes
ප්‍රභව	Sources
ප්‍රභවයක්	Source
ප්‍රභාසංස්ලේෂණය	Photosynthesis
ප්‍රභූවරයා	VIPs
ප්‍රභූවරුන්	VIP
ප්‍රභේද	Variants
ප්‍රභේදය	Category
ප්‍රමද	Late
ප්‍රමාණය	Size
ප්‍රමාණවත්	Enough
ප්‍රමාණාත්මකව	Volumes
ප්‍රමාදය	Delay
ප්‍රමානය	Late
ප්‍රමිතිකරණ	Standardization
ප්‍රමිතිය	Quality
ප්‍රමිතියක	Quality
ප්‍රමිතියකින්	Quality
ප්‍රමිතියට	Standards
ප්‍රමුඛ	Priority
ප්‍රමුඛතාවය	Priority
ප්‍රමුඛයා	Leader
ප්‍රමුඛස්ථානය	Priority
ප්‍රයත්නය	Effort
ප්‍රයෝග	Effects
ප්‍රයෝජන	Benefits
ප්‍රයෝජනය	Benefit
ප්‍රයෝජනයක්	Benefit
ප්‍රයෝජනවත්	Useful
ප්‍රතිශත	Percentage
ප්‍රතිශතය	Percentage
ප්‍රතිශෝධනයේ	Revised
ප්‍රතිසංවිධානය	Reorganization
ප්‍රතිසංස්කරණය	Reconstruction
ප්‍රථම	First
ප්‍රථමයෙන්ම	First
ප්‍රථමවර	Primary
ප්‍රථමවරට	First
ප්‍රථමාධාර	First Aid
ප්‍රදක්ෂිණා	.When
ප්‍රදර්ශනය	exhibition
ප්‍රදර්ශනාගාර	Showrooms
ප්‍රදර්ශනාගාරය	Showroom
ප්‍රදර්ශනාත්මක	Exhibition
ප්‍රදානය	Awarded
ප්‍රදානෝත්සවය	Ceremony
ප්‍රදාහය	Sinusitis
ප්‍රදීපාගාරය	Lighthouse
ප්‍රදේශවල	Areas
ප්‍රදේශවලින්	From
ප්‍රදේශවාසී	Area
ප්‍රදේශවාසීන්	Residents
ප්‍රදේශවාසීහු	Residents
ප්‍රධාන	Chief
ප්‍රධානත්වයෙන්	Headed
ප්‍රධානව	The main
ප්‍රධානියා	Head
ප්‍රතිප්‍රහාර	counter attack
ප්‍රතිප්‍රහාරය	counter attack
ප්‍රතිපාදන	Provision
ප්‍රතිඵල	results
ප්‍රතිබිම්බ	Imaging
ප්‍රතිබිම්බය	Reflection
ප්‍රතිභාපූර්ණ	Entering the
ප්‍රතිභාව	Intuition
ප්‍රතිමාව	Statue
ප්‍රතිමාවක්	Statue
ප්‍රතිරූපය	Image
ප්‍රතිරූපයට	Image
ප්‍රතිරෝධ	Resistant
ප්‍රතිරෝධය	Resistance
ප්‍රතිලාභ	Benefits
ප්‍රතිලාභය	Benefit
ප්‍රතිලාභීන්	Beneficiaries
ප්‍රතිලෝම	Inverse
ප්‍රතිව්‍යුහගතකරණය	Restructuring
ප්‍රතිවාදී	Rival
ප්‍රතිවාදීන්	Opponent
ප්‍රතිවාදීහු	Prativādīhu
ප්‍රතිවිරුද්ධ	The opposite
ප්‍රතිවිරෝධීව	In opposition
ප්‍රතිශක්තිකරණය	Immunizations
ප්‍රතිශක්තිය	Immunity
ප්‍රජාව	Community
ප්‍රජාශාලාවක්	Hall
ප්‍රඥාප්ති	Enactment
ප්‍රඥාව	Wisdom
ප්‍රණාමය	Tribute
ප්‍රණීත	Delicious
ප්‍රත්‍යක්ෂය	Manifest
ප්‍රත්‍යාස්ථ	Elastic
ප්‍රතාපවත්	The magnificent
ප්‍රතිඔක්සිහාරකයක්	Pratioksihārakayak
ප්‍රතිකර්මයක්	Treatment
ප්‍රතික්ෂේප	refused
ප්‍රතික්‍රියාව	Reaction
ප්‍රතිකාර	Treatment
ප්‍රතිකාරය	Treatment
ප්‍රතිකේෂ්ප	Reject
ප්‍රතිග්‍රහණය	Adoption
ප්‍රතිගාමි	Reactionary
ප්‍රතිගාමීන්	Reactionaries
ප්‍රතිචක්‍රීකරණ	Recycling
ප්‍රතිචාර	Responses
ප්‍රතිචාරය	Reaction
ප්‍රතිචාරයක්	Response
ප්‍රතිජීවක	Antibiotics
ප්‍රතිඥා	Pledges
ප්‍රතිඥාව	Pledge
ප්‍රතිදාන	Output
ප්‍රතිදේහ	Antibodies
ප්‍රතිදේහජනකය	Antigen
ප්‍රතිදේහය	Antigens
ප්‍රතිදේහයක්	Antibody
ප්‍රතිනිර්මාණය	Re
ප්‍රතිපත්ති	policy
ප්‍රතිපල	Results
ප්‍රකට	Known
ප්‍රක්ෂිප්තයක්	Prakṣiptayak
ප්‍රක්ෂේපණය	Projections
ප්‍රක්ෂේපනය	Projection
ප්‍රකාශකවරුන්	Publisher
ප්‍රකාශන	Publications
ප්‍රකාශයන්	Statements
ප්‍රකාශිත	Face
ප්‍රකෘති	Default
ප්‍රකේෂ්පන	Prakēṣpana
ප්‍රකෝපවන	Provocative
ප්‍රගතිය	Progress
ප්‍රගතිශීලී	Progressive
ප්‍රගමනය	Upgrade
ප්‍රගමනයට	Advancement
ප්‍රගුණ	Practice
ප්‍රගුන	Progress
ප්‍රචණ්ඩ	Violence
ප්‍රචණ්ඩකාරී	Violent
ප්‍රචණ්ඩත්වය	Violence
ප්‍රචලිත	Popular
ප්‍රචාර	Propaganda
ප්‍රචාරක	Campaign
ප්‍රචාරය	Advertise
ප්‍රචාරයක්	Campaign
ප්‍රජනන	Reproductive
ප්‍රජාතත්ත්‍රවාදය	Democracy
ප්‍රජාතන්ත්‍ර	Democratic
ප්‍රජාතන්ත්‍රවාදයේ	Democracy
ප්‍රජාතන්ත්‍රවාදි	Democratic
ප්‍රජාතන්ත්‍රවාදීව	Democratically
ප්‍රජාතාන්ත්‍රික	Democratic
ප්‍රජාතාන්ත්‍රීය	Democratic
ප්‍රජාමූල	Community
පහසුකම්	facilities
පහසුව	Convenience
පහළ	Down
පහළොව	Fifteen
පහළොස්	Fifteenth
පහුකරගෙන	Dome
පහුගිය	Recently
පහුවුණත්	Pahuvuṇat
පහුවෙනිදත්	The morning
පහුවෙනිදම	The morning
පහුවෙනිදා	The next
පහුවෙලත්	Will get
පහුවෙලා	Will get
පළකිරීම	Posting
පළතුර	Fruit
පළතුරු	fruit
පළඳින	Dress
පළපුරුද්ද	Experience
පළපුරුදු	Experience
පළමු	First
පළමුවැනිදා	To the first
පළමුවෙන්ම	First
පළල	Width
පළල්	Broad
පළලින්	Width
පළවැනි	Is the first
පළවැනිදා	Without their
පළවුනා	Single
පළවෙනවා	Bear
පළා	Provinces
පළාගිය	Fled
පළාත	Province
පළාත්	provincial
පළාත්වාසී	Paḷātvāsī
පළාත්සභා	Provincial Council
පළායයි	Fleeing
පළිගන්න	Vengeance
පළිගැනීම	Vengeance
පළිගු	Crystal
පළිඟු	Crystal
පළිහ	Shield
පළු	Palu
පළුදු	Tampering
ප්ලාස්කුවේ	Flask
ප්ලාස්ටරයේ	Plastic
ප්ලාස්ටර්	Plaster
ප්ලාස්ටික්	Plastic
ප්ලේ	Playing
ප්ලේට්	Plate
පසුතලය	Background
පසුතැවීමක්	Regrets
පසුදින	Day
පසුපස	Follow
පසුපෙල	The ranks
පසුපෙළ	Comprising
පසුබෑම	Downturn
පසුබිම	Background
පසුම්බිය	Wallet
පසුවීම	Predicted
පසුවෙනවා	Fall behind
පහකිරීමේ	Unseat
පහතරට	Low country
රට   country
රටකි  country
පහත්වී	Scrapings
පහදා	Explain
පහන	Light
පහන්	Lamps
පහමාරයි	half past five
පහයි	Five
පහර	Hit
පහරදී	Assaulted
පහරදීම	Attack
පහරදීමේ	Assault
පහරදුන්	Assault
පහරදෙන	Attack
පහරවල්	Strokes
පහල	lower
පහලවී	Embarked
පහලින්	Below
පහලොව	GST
පහස	Reads
පහසු	Easy
පහසුකම	Facility
පවරනවා	Assign
පවරා	Notice
පවසනවා	Says
පවසයි	says
පවැත්වීමට	Tiki
පවිත්‍ර	Clean
පවිත්‍රකරණ	Cleanliness
පවිත්‍රාගාර	Treatment
පවිත්‍රාගාරය	Treatment
පවු	Beers
පවුඩර්	Powder
පවුම්	£
පවුර	Wall
පවුල	Family
පවුල්	families
පවුල්වාදය	Bandism
පවුලේ	Family
පශ්චාත්	Post
පශු	of Livestock
පශුවෛද්‍ය	Veterinary
පස	Soil
පසකින්	Side
පසඟ	Fell
පසළොස්වක	Full Moon
පස්වරුව	Evening
පස්ස	Ass
පස්සේ	After
පස්හැවිරිදි	Five-
පසාරු	Sword
පසිඳලීම	Administration
පසුකලක	Later
පසුකලකදි	Later,
පසුකලකදී	Later,
පසුකාලීන	Later
පසුගාමී	lagging behind
පසුතල	Settings
පරීක්ෂණය	Examination
පරීක්ෂණයන්	TESTS
පරීක්ෂන	Inquiry
පරීක්ෂාකර	Tested
පරීක්ෂාව	Test
පරුෂ	Filth
පරෙස්සම්	Beware
පරෙස්සමින්	Carefully
පරෙස්සමෙන්	Carefully
පල	Fruit
පලංචියක	Scaffolding
පලකරන	Published
පලතුරු	fruits
පලදාව	Eat
පලයං	Denied access
පලස	Carpet
පලසින්	Awaits
පල්	Stagnation
පල්ලම	Pallama
පල්ලම්	Down
පල්ලිය	the church
පල්වුණු	Stagnation
පල්වෙන	Anemic
පලායාම	Escape
පලිගැනීමක්	Victimization
පලිබෝධ	Pests
පලිය	Vengeance
පවට	Merits and
පවත්වනවා	Hold
පවත්වයි	Holds
පවත්වාගැනීම	Maintaining
පවතිනවා	There
පවතී	There
පවන්	Pawan
පරිනිර්වාණය	Tine
පරිපථ	Circuit
පරිප්පු	Dhal
පරිපාටිය	Procedure
පරිපාලක	Admin
පරිපාලනය	administration
පරිපීඩිත	Oppressed
පරිපුර්ණ	Perfect
පරිපූර්ණව	Perfect
පරිබාහිර	External
පරිභෝජනය	Consumption
පරිමාණය	Scale
පරිමාව	Volume
පරිවර්තනය	translation
පරිවහන	Logistics
පරිවාරක	Insulation
පරිවෘත්තිය	Metabolism
පරිශ්‍රමයක	Drive
පරිශ්‍රය	Premises
පරිශීලනය	References
පරිසරය	Environment
පරිසරවේදියා	Environmentalists
පරිසරික	Environment
පරිස්සං	Careful
පරිස්සම්	Beware
පරිහරණය	use
පරිහාණිය	Decline
පරිහානිය	Decline
පරීක්ෂකවරයා	Examiner
පරමාණුව	Atom
පරමාදර්ශී	Ideal
පරමාධිපත්‍යය   	Sovereignty
පරමානු	Atom
පරමායුෂ	Birth
පරමාර්ථ	Objectives
පරමාර්ථය	Objective
පරලොව	Hereafter
පරවියා	pigeon
පරසතුරු	Dhathusena
පරස්පරය	Arbitrage
පර්යේෂක	Researcher
පර්යේෂණය	Research
පර්යේෂණාගාරය	Research
පර්යේෂන	Research
පර්වතය	the rock
පරාගනයට	Pollination
පරාජය	Beat
පරාධීන	Bondage
පරාවර්තනය	Reflection
පරාසය	Range
පරිකල්පන	Fiction
පරික්ෂණය	Test
පරික්ෂාකාරී	Checking
පරික්ෂාකරනවා   Checking
පරිගණකය	computer
පරිගණක  computer
පරිගනක	Computer
පරිඝණක	Computer
පරිඝනක	Computer
පරිච්ජේදය	Chapter
පරිණත	Maturity
පරිණාමය	Evolution
පරිත්‍යාගය	Donation
පරිත්‍යාගකරනවා     Donating
පරිත්‍යාශීලි	Parityāśīli
පරිදි	as
පරිනාමය	Evolution
පන්නරය	Momentum
පන්සල	Temple
පන්සලට	The temple
පන්සල්	Temples
පන්සිල්	Hendry
පන්හිඳ	Stylus
පනා	Combs
පනිනවා	Jump
පඳුරු	Shrubs
පපුව	Chest
පබළු	Beads
පමණයි	Only
පමනක්	only
පමාවීම	Pending
පමාවෙලා	Starving
පඹයකු	Stooge
පයට	Foot
පයින්	on foot
පයිප්ප	Pipes
පයිලට්	Pilot
පයෙන්	Foot
පයේ	Leg
පරක්කු	Late
පරගැති	Biblical
පරණ	Old
පරතරය	Gap
පරතෙර	Paratera
පරදාර	Adultery
පරදේශ	Alien
පරපුර	Generation
පරපෝෂිතයන්	Parasites
පරම	Absolutely
පරම්පරාගත	Traditions
පරමාණු	Atoms
පදක්කම	Medal
පදක්කම්	Medals
පදක්කම්ලාභියා	Medalist
පදනම	Base
උයයි           cooking

පදම්කළ	OmniBalance
පදය	Password
පදයක්	Verse
පදවනවා	Driving
පදවන්නන්	Motorists
පදවිය	Post
පද්ධතිය	system
පද්ධතිවල	Systems
පද්ධතීන්	Systems
පද්‍ය	Poetry
පදාර්ථ	Matter
පදිංචිකරුවෝ	Residents
පදිංචිය	Residential
පදිංචිවීම	Resettlement
පදික	Pavement
පදිකවේදිකාවේ	Crosswalks
පදිනවා	Bike
පන	Survival
පනත	Act
පනතකට	In Massachusetts,
පනතකවත්	Bill
පනතක්	Bill
පනතට	Bill
පනත්	Bills
පනහ	Fifty
පන්තිභාර	Pantibhāra
පන්දම්	Candles
පන්දු	Tennis
පන්දුයවන්නා	Bowler
පන්දුරකින්නා	Batsman
පන්දුව	Ball
පන්නනවා	Norrie
පට්ටිය	Pattiya
පටිය	Belt
පටුන	Table of Contents
පටුමග	Lane
පඩිපෙළ	Staircase
පඩිය	Salary
පණගැන්විය	 Unbootable
පණ්ඩිතයා	Philosophy
පණිවුඩකරු  	Messenger
පණිවුඩය	 Message
පියාඹනවා  flying
පණු	Worm
පණුවන්	Worms
පතනට	Patanaṭa
පතමි	Good luck
පතමු	And seek
පතරොම්	Ammunition
පතල	Mine
පතල්	Mines
පත්කිරීම	Appointment
පත්තරය	The paper
පත්ල	Bottom
පත්ලට	My eyes on
පත්වන	Elected
පත්වීම	Appointment
පත්වුණා	Became
පත්වෙනවා	Tie
පත්වෙමින්	Becoming
පත්වෙයි	NCP
පත්වෙලා	Has become
පත්‍ර	Sheets
පත්‍රකලාවේදීන්	Journalists
පත්‍රය	Sheet
පත්‍රිකාව	Sheet
පති	Countermeasure
පතිතවන	Hit
පතුරුවන	Spread
පතුල	Bed
පතොරම්	Ammunition
පථ	Paths
පථය	Scope
පද	Keywords
පක්ෂග්‍රාහී	Biased
පක්ෂපාතී	Pro
පක්ෂපාතීත්වය	Loyalty
පක්ෂපාතීව	Loyal
පක්ෂය	party
පක්ෂයට	Party
පක්ෂයේ	Party
පක්ෂව	In favor of
පක්ෂින්	Birds
පක්ෂියා	Bird
පගාවට	Bribes
පච	Phoney
පටක	Tissue
පටකවල	Tissue
පටන්ගත්තා	Started
පටන්ම	From
පටලය	Membrane
පටවනවා	Load
පටවාගෙන	Load
පටහැනිය	Contradicts
පට්ටම	Bevel
පට්ටි	Dairy
පට්ටිකා	Platelets
නොවීය	Was
නොවෙනස්	Steady
නොවෙමු	Separate
නොවේවා	Do not let
නොසඟවා	Confess
නොසතුට	Displeasure
නොසන්සුන්	Unrest
නොසලකන	Not considered
නොසැලකිලිමත්	Careless
නොසැලුණු	Despite
නොසිටීම	Absence
නොසිතන	Unexpected
නොසිතූ	Unlikely
නොසිඳෙන	Become just
නොහඳුනන	Unknown
නොහැක	No
නොහැකියාව	Incapacity
නොහැකිවීම	Failure
නොහික්මුණ	Unruly
නොහිතුව	Unexpectedly
නොහොත්	Or
නොහොබිනා	Sex
නෝට්ටු	Notes
නෝනා	Nona
නෞකා	Ships
නෞකාව	Ship
පංගුව	Share
පංගුවක්	Portions
පංති	Classes
පංතිය	Class
පංතියක්	FORTH
පංතියට	Class
පංසල	Temple
නොපසුබට	Perseverance
නොපැහැදිලි	Fuzzy
නොපුරුදු	Not rise
නොපෙනුණ	Invisible
නොබැලීම	Impartial
නොමග	Misleading
නොමඳ	Focus
නොමසුරු	Generous
නොමැකෙන	Lasting
නොමැත	not
නොමැති	is not
නොමැතිකම	Lackof
නොමිලේ	Free
නොයෙක්	Many
නොරැකෙන	Undoing
නොරැදෙන	Trot
දෙනවා     giving
දුන්නා         gave
දෙන්න give
නොරිස්සන	Edgy
නොරිස්සුම්	Resentment
නොලැබීම	The lack of
නොලැබුණ	Were deprived
නොලියූ	Lamentations
නොවරදවාම	Fail
නොවැටහෙන	Mystery
නොවැටීම	Toavoid
නොවැඩුණු	Evolved
නොවැම්බර්	November
නොවැළැක්විය	Unavoidable
නොවිමසා	Review
නොවිසඳෙන	Unresolved
නොවී	Without
නොවීම	Lackof
